Datetime,100034982 (Hüfferstraße),101034982 (Hüfferstraße stadteinwärts),102034982 (Hüfferstraße stadtauswärts),100034982-status,101034982-status,102034982-status
2022-04-01 00:00,8,5,3,0,0,0
2022-04-01 00:15,1,1,0,0,0,0
2022-04-01 00:30,4,1,3,0,0,0
2022-04-01 00:45,5,2,3,0,0,0
2022-04-01 01:00,3,3,0,0,0,0
2022-04-01 01:15,8,7,1,0,0,0
2022-04-01 01:30,8,1,7,0,0,0
2022-04-01 01:45,1,0,1,0,0,0
2022-04-01 02:00,4,1,3,0,0,0
2022-04-01 02:15,3,1,2,0,0,0
2022-04-01 02:30,3,2,1,0,0,0
2022-04-01 02:45,2,0,2,0,0,0
2022-04-01 03:00,3,0,3,0,0,0
2022-04-01 03:15,1,0,1,0,0,0
2022-04-01 03:30,2,0,2,0,0,0
2022-04-01 03:45,1,0,1,0,0,0
2022-04-01 04:00,2,0,2,0,0,0
2022-04-01 04:15,0,0,0,0,0,0
2022-04-01 04:30,5,0,5,0,0,0
2022-04-01 04:45,0,0,0,0,0,0
2022-04-01 05:00,2,0,2,0,0,0
2022-04-01 05:15,3,1,2,0,0,0
2022-04-01 05:30,6,3,3,0,0,0
2022-04-01 05:45,13,1,12,0,0,0
2022-04-01 06:00,7,3,4,0,0,0
2022-04-01 06:15,8,0,8,0,0,0
2022-04-01 06:30,14,6,8,0,0,0
2022-04-01 06:45,40,15,25,0,0,0
2022-04-01 07:00,48,15,33,0,0,0
2022-04-01 07:15,57,28,29,0,0,0
2022-04-01 07:30,158,103,55,0,0,0
2022-04-01 07:45,136,68,68,0,0,0
2022-04-01 08:00,105,32,73,0,0,0
2022-04-01 08:15,81,25,56,0,0,0
2022-04-01 08:30,87,48,39,0,0,0
2022-04-01 08:45,93,24,69,0,0,0
2022-04-01 09:00,68,25,43,0,0,0
2022-04-01 09:15,51,22,29,0,0,0
2022-04-01 09:30,64,42,22,0,0,0
2022-04-01 09:45,63,31,32,0,0,0
2022-04-01 10:00,38,18,20,0,0,0
2022-04-01 10:15,42,16,26,0,0,0
2022-04-01 10:30,55,18,37,0,0,0
2022-04-01 10:45,32,19,13,0,0,0
2022-04-01 11:00,35,14,21,0,0,0
2022-04-01 11:15,41,18,23,0,0,0
2022-04-01 11:30,52,23,29,0,0,0
2022-04-01 11:45,49,26,23,0,0,0
2022-04-01 12:00,38,18,20,0,0,0
2022-04-01 12:15,60,23,37,0,0,0
2022-04-01 12:30,61,22,39,0,0,0
2022-04-01 12:45,48,27,21,0,0,0
2022-04-01 13:00,80,38,42,0,0,0
2022-04-01 13:15,101,29,72,0,0,0
2022-04-01 13:30,52,17,35,0,0,0
2022-04-01 13:45,53,21,32,0,0,0
2022-04-01 14:00,98,32,66,0,0,0
2022-04-01 14:15,66,34,32,0,0,0
2022-04-01 14:30,67,43,24,0,0,0
2022-04-01 14:45,64,29,35,0,0,0
2022-04-01 15:00,67,37,30,0,0,0
2022-04-01 15:15,78,48,30,0,0,0
2022-04-01 15:30,65,35,30,0,0,0
2022-04-01 15:45,85,55,30,0,0,0
2022-04-01 16:00,56,37,19,0,0,0
2022-04-01 16:15,60,27,33,0,0,0
2022-04-01 16:30,45,22,23,0,0,0
2022-04-01 16:45,63,39,24,0,0,0
2022-04-01 17:00,49,24,25,0,0,0
2022-04-01 17:15,41,23,18,0,0,0
2022-04-01 17:30,49,21,28,0,0,0
2022-04-01 17:45,54,33,21,0,0,0
2022-04-01 18:00,59,31,28,0,0,0
2022-04-01 18:15,33,15,18,0,0,0
2022-04-01 18:30,41,20,21,0,0,0
2022-04-01 18:45,43,24,19,0,0,0
2022-04-01 19:00,24,9,15,0,0,0
2022-04-01 19:15,29,15,14,0,0,0
2022-04-01 19:30,28,12,16,0,0,0
2022-04-01 19:45,23,9,14,0,0,0
2022-04-01 20:00,20,14,6,0,0,0
2022-04-01 20:15,16,10,6,0,0,0
2022-04-01 20:30,20,11,9,0,0,0
2022-04-01 20:45,22,10,12,0,0,0
2022-04-01 21:00,23,16,7,0,0,0
2022-04-01 21:15,19,11,8,0,0,0
2022-04-01 21:30,13,6,7,0,0,0
2022-04-01 21:45,6,3,3,0,0,0
2022-04-01 22:00,23,10,13,0,0,0
2022-04-01 22:15,16,5,11,0,0,0
2022-04-01 22:30,7,3,4,0,0,0
2022-04-01 22:45,10,5,5,0,0,0
2022-04-01 23:00,10,3,7,0,0,0
2022-04-01 23:15,7,5,2,0,0,0
2022-04-01 23:30,16,5,11,0,0,0
2022-04-01 23:45,10,9,1,0,0,0
2022-04-02 00:00,11,8,3,0,0,0
2022-04-02 00:15,0,0,0,0,0,0
2022-04-02 00:30,13,4,9,0,0,0
2022-04-02 00:45,8,2,6,0,0,0
2022-04-02 01:00,6,0,6,0,0,0
2022-04-02 01:15,9,4,5,0,0,0
2022-04-02 01:30,8,1,7,0,0,0
2022-04-02 01:45,7,2,5,0,0,0
2022-04-02 02:00,2,0,2,0,0,0
2022-04-02 02:15,14,8,6,0,0,0
2022-04-02 02:30,9,5,4,0,0,0
2022-04-02 02:45,4,2,2,0,0,0
2022-04-02 03:00,6,1,5,0,0,0
2022-04-02 03:15,4,1,3,0,0,0
2022-04-02 03:30,5,2,3,0,0,0
2022-04-02 03:45,10,2,8,0,0,0
2022-04-02 04:00,4,0,4,0,0,0
2022-04-02 04:15,2,1,1,0,0,0
2022-04-02 04:30,2,1,1,0,0,0
2022-04-02 04:45,1,0,1,0,0,0
2022-04-02 05:00,0,0,0,0,0,0
2022-04-02 05:15,1,0,1,0,0,0
2022-04-02 05:30,3,1,2,0,0,0
2022-04-02 05:45,6,0,6,0,0,0
2022-04-02 06:00,3,1,2,0,0,0
2022-04-02 06:15,8,2,6,0,0,0
2022-04-02 06:30,2,1,1,0,0,0
2022-04-02 06:45,14,11,3,0,0,0
2022-04-02 07:00,9,6,3,0,0,0
2022-04-02 07:15,5,2,3,0,0,0
2022-04-02 07:30,10,3,7,0,0,0
2022-04-02 07:45,19,6,13,0,0,0
2022-04-02 08:00,17,7,10,0,0,0
2022-04-02 08:15,23,20,3,0,0,0
2022-04-02 08:30,17,9,8,0,0,0
2022-04-02 08:45,20,13,7,0,0,0
2022-04-02 09:00,21,15,6,0,0,0
2022-04-02 09:15,31,26,5,0,0,0
2022-04-02 09:30,51,32,19,0,0,0
2022-04-02 09:45,53,28,25,0,0,0
2022-04-02 10:00,39,23,16,0,0,0
2022-04-02 10:15,37,14,23,0,0,0
2022-04-02 10:30,36,18,18,0,0,0
2022-04-02 10:45,68,44,24,0,0,0
2022-04-02 11:00,53,26,27,0,0,0
2022-04-02 11:15,63,39,24,0,0,0
2022-04-02 11:30,50,28,22,0,0,0
2022-04-02 11:45,76,46,30,0,0,0
2022-04-02 12:00,73,41,32,0,0,0
2022-04-02 12:15,62,31,31,0,0,0
2022-04-02 12:30,68,40,28,0,0,0
2022-04-02 12:45,65,36,29,0,0,0
2022-04-02 13:00,55,23,32,0,0,0
2022-04-02 13:15,66,24,42,0,0,0
2022-04-02 13:30,71,38,33,0,0,0
2022-04-02 13:45,64,39,25,0,0,0
2022-04-02 14:00,55,35,20,0,0,0
2022-04-02 14:15,81,47,34,0,0,0
2022-04-02 14:30,57,21,36,0,0,0
2022-04-02 14:45,62,23,39,0,0,0
2022-04-02 15:00,64,38,26,0,0,0
2022-04-02 15:15,66,38,28,0,0,0
2022-04-02 15:30,59,27,32,0,0,0
2022-04-02 15:45,51,22,29,0,0,0
2022-04-02 16:00,46,20,26,0,0,0
2022-04-02 16:15,46,16,30,0,0,0
2022-04-02 16:30,38,16,22,0,0,0
2022-04-02 16:45,42,19,23,0,0,0
2022-04-02 17:00,49,19,30,0,0,0
2022-04-02 17:15,35,10,25,0,0,0
2022-04-02 17:30,36,14,22,0,0,0
2022-04-02 17:45,58,30,28,0,0,0
2022-04-02 18:00,31,15,16,0,0,0
2022-04-02 18:15,53,22,31,0,0,0
2022-04-02 18:30,46,14,32,0,0,0
2022-04-02 18:45,61,24,37,0,0,0
2022-04-02 19:00,42,21,21,0,0,0
2022-04-02 19:15,30,10,20,0,0,0
2022-04-02 19:30,30,18,12,0,0,0
2022-04-02 19:45,35,12,23,0,0,0
2022-04-02 20:00,45,20,25,0,0,0
2022-04-02 20:15,31,6,25,0,0,0
2022-04-02 20:30,17,9,8,0,0,0
2022-04-02 20:45,14,4,10,0,0,0
2022-04-02 21:00,20,9,11,0,0,0
2022-04-02 21:15,21,15,6,0,0,0
2022-04-02 21:30,6,3,3,0,0,0
2022-04-02 21:45,14,6,8,0,0,0
2022-04-02 22:00,8,3,5,0,0,0
2022-04-02 22:15,15,4,11,0,0,0
2022-04-02 22:30,27,5,22,0,0,0
2022-04-02 22:45,16,2,14,0,0,0
2022-04-02 23:00,11,6,5,0,0,0
2022-04-02 23:15,14,2,12,0,0,0
2022-04-02 23:30,12,3,9,0,0,0
2022-04-02 23:45,21,8,13,0,0,0
2022-04-03 00:00,15,6,9,0,0,0
2022-04-03 00:15,11,5,6,0,0,0
2022-04-03 00:30,4,1,3,0,0,0
2022-04-03 00:45,4,0,4,0,0,0
2022-04-03 01:00,6,1,5,0,0,0
2022-04-03 01:15,6,3,3,0,0,0
2022-04-03 01:30,7,1,6,0,0,0
2022-04-03 01:45,5,0,5,0,0,0
2022-04-03 02:00,8,1,7,0,0,0
2022-04-03 02:15,10,2,8,0,0,0
2022-04-03 02:30,3,1,2,0,0,0
2022-04-03 02:45,6,1,5,0,0,0
2022-04-03 03:00,13,1,12,0,0,0
2022-04-03 03:15,2,1,1,0,0,0
2022-04-03 03:30,9,1,8,0,0,0
2022-04-03 03:45,9,1,8,0,0,0
2022-04-03 04:00,5,2,3,0,0,0
2022-04-03 04:15,4,1,3,0,0,0
2022-04-03 04:30,6,0,6,0,0,0
2022-04-03 04:45,3,0,3,0,0,0
2022-04-03 05:00,1,0,1,0,0,0
2022-04-03 05:15,4,0,4,0,0,0
2022-04-03 05:30,1,0,1,0,0,0
2022-04-03 05:45,4,0,4,0,0,0
2022-04-03 06:00,4,2,2,0,0,0
2022-04-03 06:15,2,2,0,0,0,0
2022-04-03 06:30,3,2,1,0,0,0
2022-04-03 06:45,7,3,4,0,0,0
2022-04-03 07:00,4,2,2,0,0,0
2022-04-03 07:15,2,1,1,0,0,0
2022-04-03 07:30,0,0,0,0,0,0
2022-04-03 07:45,12,7,5,0,0,0
2022-04-03 08:00,3,2,1,0,0,0
2022-04-03 08:15,4,3,1,0,0,0
2022-04-03 08:30,8,7,1,0,0,0
2022-04-03 08:45,22,11,11,0,0,0
2022-04-03 09:00,13,8,5,0,0,0
2022-04-03 09:15,10,9,1,0,0,0
2022-04-03 09:30,18,11,7,0,0,0
2022-04-03 09:45,25,10,15,0,0,0
2022-04-03 10:00,25,18,7,0,0,0
2022-04-03 10:15,11,5,6,0,0,0
2022-04-03 10:30,24,14,10,0,0,0
2022-04-03 10:45,24,13,11,0,0,0
2022-04-03 11:00,17,8,9,0,0,0
2022-04-03 11:15,16,3,13,0,0,0
2022-04-03 11:30,15,5,10,0,0,0
2022-04-03 11:45,23,10,13,0,0,0
2022-04-03 12:00,24,10,14,0,0,0
2022-04-03 12:15,19,10,9,0,0,0
2022-04-03 12:30,40,10,30,0,0,0
2022-04-03 12:45,30,14,16,0,0,0
2022-04-03 13:00,26,14,12,0,0,0
2022-04-03 13:15,24,9,15,0,0,0
2022-04-03 13:30,22,9,13,0,0,0
2022-04-03 13:45,33,10,23,0,0,0
2022-04-03 14:00,23,5,18,0,0,0
2022-04-03 14:15,23,11,12,0,0,0
2022-04-03 14:30,24,10,14,0,0,0
2022-04-03 14:45,32,11,21,0,0,0
2022-04-03 15:00,18,5,13,0,0,0
2022-04-03 15:15,34,13,21,0,0,0
2022-04-03 15:30,36,13,23,0,0,0
2022-04-03 15:45,26,12,14,0,0,0
2022-04-03 16:00,36,20,16,0,0,0
2022-04-03 16:15,31,15,16,0,0,0
2022-04-03 16:30,31,8,23,0,0,0
2022-04-03 16:45,36,9,27,0,0,0
2022-04-03 17:00,31,10,21,0,0,0
2022-04-03 17:15,38,21,17,0,0,0
2022-04-03 17:30,31,15,16,0,0,0
2022-04-03 17:45,33,11,22,0,0,0
2022-04-03 18:00,42,18,24,0,0,0
2022-04-03 18:15,29,10,19,0,0,0
2022-04-03 18:30,37,14,23,0,0,0
2022-04-03 18:45,39,28,11,0,0,0
2022-04-03 19:00,28,10,18,0,0,0
2022-04-03 19:15,21,14,7,0,0,0
2022-04-03 19:30,16,10,6,0,0,0
2022-04-03 19:45,23,6,17,0,0,0
2022-04-03 20:00,27,12,15,0,0,0
2022-04-03 20:15,25,1,24,0,0,0
2022-04-03 20:30,20,6,14,0,0,0
2022-04-03 20:45,14,3,11,0,0,0
2022-04-03 21:00,6,4,2,0,0,0
2022-04-03 21:15,10,4,6,0,0,0
2022-04-03 21:30,10,0,10,0,0,0
2022-04-03 21:45,11,2,9,0,0,0
2022-04-03 22:00,10,2,8,0,0,0
2022-04-03 22:15,5,1,4,0,0,0
2022-04-03 22:30,11,7,4,0,0,0
2022-04-03 22:45,9,0,9,0,0,0
2022-04-03 23:00,6,0,6,0,0,0
2022-04-03 23:15,8,6,2,0,0,0
2022-04-03 23:30,3,1,2,0,0,0
2022-04-03 23:45,4,2,2,0,0,0
2022-04-04 00:00,0,0,0,0,0,0
2022-04-04 00:15,6,0,6,0,0,0
2022-04-04 00:30,3,0,3,0,0,0
2022-04-04 00:45,1,0,1,0,0,0
2022-04-04 01:00,2,2,0,0,0,0
2022-04-04 01:15,4,2,2,0,0,0
2022-04-04 01:30,0,0,0,0,0,0
2022-04-04 01:45,0,0,0,0,0,0
2022-04-04 02:00,0,0,0,0,0,0
2022-04-04 02:15,1,1,0,0,0,0
2022-04-04 02:30,0,0,0,0,0,0
2022-04-04 02:45,0,0,0,0,0,0
2022-04-04 03:00,1,0,1,0,0,0
2022-04-04 03:15,0,0,0,0,0,0
2022-04-04 03:30,0,0,0,0,0,0
2022-04-04 03:45,0,0,0,0,0,0
2022-04-04 04:00,0,0,0,0,0,0
2022-04-04 04:15,1,0,1,0,0,0
2022-04-04 04:30,1,1,0,0,0,0
2022-04-04 04:45,1,1,0,0,0,0
2022-04-04 05:00,0,0,0,0,0,0
2022-04-04 05:15,1,0,1,0,0,0
2022-04-04 05:30,8,0,8,0,0,0
2022-04-04 05:45,12,7,5,0,0,0
2022-04-04 06:00,9,3,6,0,0,0
2022-04-04 06:15,13,4,9,0,0,0
2022-04-04 06:30,28,7,21,0,0,0
2022-04-04 06:45,47,17,30,0,0,0
2022-04-04 07:00,59,23,36,0,0,0
2022-04-04 07:15,80,43,37,0,0,0
2022-04-04 07:30,250,147,103,0,0,0
2022-04-04 07:45,169,74,95,0,0,0
2022-04-04 08:00,173,56,117,0,0,0
2022-04-04 08:15,122,55,67,0,0,0
2022-04-04 08:30,111,57,54,0,0,0
2022-04-04 08:45,137,44,93,0,0,0
2022-04-04 09:00,97,36,61,0,0,0
2022-04-04 09:15,68,45,23,0,0,0
2022-04-04 09:30,82,35,47,0,0,0
2022-04-04 09:45,146,56,90,0,0,0
2022-04-04 10:00,118,38,80,0,0,0
2022-04-04 10:15,65,44,21,0,0,0
2022-04-04 10:30,58,31,27,0,0,0
2022-04-04 10:45,62,33,29,0,0,0
2022-04-04 11:00,105,69,36,0,0,0
2022-04-04 11:15,65,31,34,0,0,0
2022-04-04 11:30,64,20,44,0,0,0
2022-04-04 11:45,92,46,46,0,0,0
2022-04-04 12:00,94,42,52,0,0,0
2022-04-04 12:15,95,28,67,0,0,0
2022-04-04 12:30,97,32,65,0,0,0
2022-04-04 12:45,76,40,36,0,0,0
2022-04-04 13:00,103,39,64,0,0,0
2022-04-04 13:15,107,42,65,0,0,0
2022-04-04 13:30,89,39,50,0,0,0
2022-04-04 13:45,121,55,66,0,0,0
2022-04-04 14:00,108,42,66,0,0,0
2022-04-04 14:15,70,35,35,0,0,0
2022-04-04 14:30,84,49,35,0,0,0
2022-04-04 14:45,91,42,49,0,0,0
2022-04-04 15:00,106,67,39,0,0,0
2022-04-04 15:15,73,45,28,0,0,0
2022-04-04 15:30,73,38,35,0,0,0
2022-04-04 15:45,126,89,37,0,0,0
2022-04-04 16:00,111,77,34,0,0,0
2022-04-04 16:15,117,62,55,0,0,0
2022-04-04 16:30,84,48,36,0,0,0
2022-04-04 16:45,97,64,33,0,0,0
2022-04-04 17:00,103,61,42,0,0,0
2022-04-04 17:15,65,24,41,0,0,0
2022-04-04 17:30,92,45,47,0,0,0
2022-04-04 17:45,75,41,34,0,0,0
2022-04-04 18:00,74,24,50,0,0,0
2022-04-04 18:15,66,28,38,0,0,0
2022-04-04 18:30,50,25,25,0,0,0
2022-04-04 18:45,44,21,23,0,0,0
2022-04-04 19:00,36,17,19,0,0,0
2022-04-04 19:15,36,17,19,0,0,0
2022-04-04 19:30,41,26,15,0,0,0
2022-04-04 19:45,38,14,24,0,0,0
2022-04-04 20:00,27,5,22,0,0,0
2022-04-04 20:15,31,8,23,0,0,0
2022-04-04 20:30,7,2,5,0,0,0
2022-04-04 20:45,14,8,6,0,0,0
2022-04-04 21:00,12,7,5,0,0,0
2022-04-04 21:15,8,3,5,0,0,0
2022-04-04 21:30,14,7,7,0,0,0
2022-04-04 21:45,7,3,4,0,0,0
2022-04-04 22:00,16,6,10,0,0,0
2022-04-04 22:15,10,7,3,0,0,0
2022-04-04 22:30,10,6,4,0,0,0
2022-04-04 22:45,15,3,12,0,0,0
2022-04-04 23:00,7,1,6,0,0,0
2022-04-04 23:15,8,2,6,0,0,0
2022-04-04 23:30,10,6,4,0,0,0
2022-04-04 23:45,2,0,2,0,0,0
2022-04-05 00:00,4,0,4,0,0,0
2022-04-05 00:15,6,1,5,0,0,0
2022-04-05 00:30,3,1,2,0,0,0
2022-04-05 00:45,2,1,1,0,0,0
2022-04-05 01:00,4,2,2,0,0,0
2022-04-05 01:15,2,1,1,0,0,0
2022-04-05 01:30,2,0,2,0,0,0
2022-04-05 01:45,1,0,1,0,0,0
2022-04-05 02:00,1,0,1,0,0,0
2022-04-05 02:15,4,1,3,0,0,0
2022-04-05 02:30,1,0,1,0,0,0
2022-04-05 02:45,3,0,3,0,0,0
2022-04-05 03:00,2,0,2,0,0,0
2022-04-05 03:15,3,0,3,0,0,0
2022-04-05 03:30,6,1,5,0,0,0
2022-04-05 03:45,1,1,0,0,0,0
2022-04-05 04:00,5,1,4,0,0,0
2022-04-05 04:15,3,0,3,0,0,0
2022-04-05 04:30,1,0,1,0,0,0
2022-04-05 04:45,1,0,1,0,0,0
2022-04-05 05:00,0,0,0,0,0,0
2022-04-05 05:15,3,1,2,0,0,0
2022-04-05 05:30,7,1,6,0,0,0
2022-04-05 05:45,7,3,4,0,0,0
2022-04-05 06:00,11,6,5,0,0,0
2022-04-05 06:15,15,2,13,0,0,0
2022-04-05 06:30,30,8,22,0,0,0
2022-04-05 06:45,46,8,38,0,0,0
2022-04-05 07:00,50,14,36,0,0,0
2022-04-05 07:15,79,39,40,0,0,0
2022-04-05 07:30,189,112,77,0,0,0
2022-04-05 07:45,208,88,120,0,0,0
2022-04-05 08:00,185,46,139,0,0,0
2022-04-05 08:15,102,47,55,0,0,0
2022-04-05 08:30,96,48,48,0,0,0
2022-04-05 08:45,121,59,62,0,0,0
2022-04-05 09:00,72,24,48,0,0,0
2022-04-05 09:15,69,31,38,0,0,0
2022-04-05 09:30,87,39,48,0,0,0
2022-04-05 09:45,105,41,64,0,0,0
2022-04-05 10:00,123,40,83,0,0,0
2022-04-05 10:15,36,18,18,0,0,0
2022-04-05 10:30,43,21,22,0,0,0
2022-04-05 10:45,62,38,24,0,0,0
2022-04-05 11:00,45,27,18,0,0,0
2022-04-05 11:15,60,31,29,0,0,0
2022-04-05 11:30,50,29,21,0,0,0
2022-04-05 11:45,126,78,48,0,0,0
2022-04-05 12:00,112,55,57,0,0,0
2022-04-05 12:15,126,61,65,0,0,0
2022-04-05 12:30,73,36,37,0,0,0
2022-04-05 12:45,60,31,29,0,0,0
2022-04-05 13:00,106,35,71,0,0,0
2022-04-05 13:15,114,34,80,0,0,0
2022-04-05 13:30,101,36,65,0,0,0
2022-04-05 13:45,162,88,74,0,0,0
2022-04-05 14:00,126,54,72,0,0,0
2022-04-05 14:15,88,48,40,0,0,0
2022-04-05 14:30,85,52,33,0,0,0
2022-04-05 14:45,96,34,62,0,0,0
2022-04-05 15:00,81,45,36,0,0,0
2022-04-05 15:15,83,46,37,0,0,0
2022-04-05 15:30,84,48,36,0,0,0
2022-04-05 15:45,173,110,63,0,0,0
2022-04-05 16:00,141,84,57,0,0,0
2022-04-05 16:15,127,73,54,0,0,0
2022-04-05 16:30,82,39,43,0,0,0
2022-04-05 16:45,84,46,38,0,0,0
2022-04-05 17:00,110,61,49,0,0,0
2022-04-05 17:15,87,52,35,0,0,0
2022-04-05 17:30,85,48,37,0,0,0
2022-04-05 17:45,107,61,46,0,0,0
2022-04-05 18:00,87,48,39,0,0,0
2022-04-05 18:15,71,37,34,0,0,0
2022-04-05 18:30,56,31,25,0,0,0
2022-04-05 18:45,76,31,45,0,0,0
2022-04-05 19:00,49,24,25,0,0,0
2022-04-05 19:15,47,17,30,0,0,0
2022-04-05 19:30,45,16,29,0,0,0
2022-04-05 19:45,25,17,8,0,0,0
2022-04-05 20:00,47,14,33,0,0,0
2022-04-05 20:15,31,12,19,0,0,0
2022-04-05 20:30,24,6,18,0,0,0
2022-04-05 20:45,20,8,12,0,0,0
2022-04-05 21:00,20,8,12,0,0,0
2022-04-05 21:15,29,12,17,0,0,0
2022-04-05 21:30,18,7,11,0,0,0
2022-04-05 21:45,31,12,19,0,0,0
2022-04-05 22:00,13,5,8,0,0,0
2022-04-05 22:15,15,7,8,0,0,0
2022-04-05 22:30,13,3,10,0,0,0
2022-04-05 22:45,9,1,8,0,0,0
2022-04-05 23:00,21,7,14,0,0,0
2022-04-05 23:15,10,3,7,0,0,0
2022-04-05 23:30,2,1,1,0,0,0
2022-04-05 23:45,3,1,2,0,0,0
2022-04-06 00:00,14,3,11,0,0,0
2022-04-06 00:15,6,1,5,0,0,0
2022-04-06 00:30,0,0,0,0,0,0
2022-04-06 00:45,3,0,3,0,0,0
2022-04-06 01:00,5,3,2,0,0,0
2022-04-06 01:15,2,0,2,0,0,0
2022-04-06 01:30,2,2,0,0,0,0
2022-04-06 01:45,5,0,5,0,0,0
2022-04-06 02:00,7,0,7,0,0,0
2022-04-06 02:15,0,0,0,0,0,0
2022-04-06 02:30,5,0,5,0,0,0
2022-04-06 02:45,1,1,0,0,0,0
2022-04-06 03:00,0,0,0,0,0,0
2022-04-06 03:15,3,1,2,0,0,0
2022-04-06 03:30,0,0,0,0,0,0
2022-04-06 03:45,1,1,0,0,0,0
2022-04-06 04:00,3,1,2,0,0,0
2022-04-06 04:15,1,0,1,0,0,0
2022-04-06 04:30,0,0,0,0,0,0
2022-04-06 04:45,0,0,0,0,0,0
2022-04-06 05:00,0,0,0,0,0,0
2022-04-06 05:15,6,1,5,0,0,0
2022-04-06 05:30,10,4,6,0,0,0
2022-04-06 05:45,10,4,6,0,0,0
2022-04-06 06:00,10,3,7,0,0,0
2022-04-06 06:15,17,6,11,0,0,0
2022-04-06 06:30,27,7,20,0,0,0
2022-04-06 06:45,56,22,34,0,0,0
2022-04-06 07:00,53,15,38,0,0,0
2022-04-06 07:15,94,41,53,0,0,0
2022-04-06 07:30,250,153,97,0,0,0
2022-04-06 07:45,180,67,113,0,0,0
2022-04-06 08:00,164,49,115,0,0,0
2022-04-06 08:15,118,57,61,0,0,0
2022-04-06 08:30,101,50,51,0,0,0
2022-04-06 08:45,164,63,101,0,0,0
2022-04-06 09:00,128,44,84,0,0,0
2022-04-06 09:15,77,36,41,0,0,0
2022-04-06 09:30,107,57,50,0,0,0
2022-04-06 09:45,133,63,70,0,0,0
2022-04-06 10:00,126,58,68,0,0,0
2022-04-06 10:15,64,44,20,0,0,0
2022-04-06 10:30,70,33,37,0,0,0
2022-04-06 10:45,77,38,39,0,0,0
2022-04-06 11:00,97,48,49,0,0,0
2022-04-06 11:15,89,50,39,0,0,0
2022-04-06 11:30,88,47,41,0,0,0
2022-04-06 11:45,159,82,77,0,0,0
2022-04-06 12:00,136,72,64,0,0,0
2022-04-06 12:15,131,68,63,0,0,0
2022-04-06 12:30,113,50,63,0,0,0
2022-04-06 12:45,102,37,65,0,0,0
2022-04-06 13:00,120,44,76,0,0,0
2022-04-06 13:15,114,51,63,0,0,0
2022-04-06 13:30,101,46,55,0,0,0
2022-04-06 13:45,160,81,79,0,0,0
2022-04-06 14:00,150,45,105,0,0,0
2022-04-06 14:15,115,58,57,0,0,0
2022-04-06 14:30,82,35,47,0,0,0
2022-04-06 14:45,110,65,45,0,0,0
2022-04-06 15:00,89,41,48,0,0,0
2022-04-06 15:15,105,62,43,0,0,0
2022-04-06 15:30,131,51,80,0,0,0
2022-04-06 15:45,130,69,61,0,0,0
2022-04-06 16:00,150,83,67,0,0,0
2022-04-06 16:15,105,56,49,0,0,0
2022-04-06 16:30,111,56,55,0,0,0
2022-04-06 16:45,116,68,48,0,0,0
2022-04-06 17:00,140,80,60,0,0,0
2022-04-06 17:15,106,66,40,0,0,0
2022-04-06 17:30,96,48,48,0,0,0
2022-04-06 17:45,175,87,88,0,0,0
2022-04-06 18:00,76,33,43,0,0,0
2022-04-06 18:15,107,51,56,0,0,0
2022-04-06 18:30,70,39,31,0,0,0
2022-04-06 18:45,86,42,44,0,0,0
2022-04-06 19:00,43,19,24,0,0,0
2022-04-06 19:15,58,28,30,0,0,0
2022-04-06 19:30,49,28,21,0,0,0
2022-04-06 19:45,55,31,24,0,0,0
2022-04-06 20:00,40,13,27,0,0,0
2022-04-06 20:15,22,6,16,0,0,0
2022-04-06 20:30,43,32,11,0,0,0
2022-04-06 20:45,30,11,19,0,0,0
2022-04-06 21:00,26,12,14,0,0,0
2022-04-06 21:15,37,20,17,0,0,0
2022-04-06 21:30,12,4,8,0,0,0
2022-04-06 21:45,39,11,28,0,0,0
2022-04-06 22:00,23,7,16,0,0,0
2022-04-06 22:15,17,4,13,0,0,0
2022-04-06 22:30,15,3,12,0,0,0
2022-04-06 22:45,15,1,14,0,0,0
2022-04-06 23:00,27,11,16,0,0,0
2022-04-06 23:15,12,1,11,0,0,0
2022-04-06 23:30,13,4,9,0,0,0
2022-04-06 23:45,9,5,4,0,0,0
2022-04-07 00:00,9,2,7,0,0,0
2022-04-07 00:15,5,3,2,0,0,0
2022-04-07 00:30,3,3,0,0,0,0
2022-04-07 00:45,9,1,8,0,0,0
2022-04-07 01:00,3,0,3,0,0,0
2022-04-07 01:15,3,2,1,0,0,0
2022-04-07 01:30,4,0,4,0,0,0
2022-04-07 01:45,3,1,2,0,0,0
2022-04-07 02:00,3,0,3,0,0,0
2022-04-07 02:15,7,0,7,0,0,0
2022-04-07 02:30,6,0,6,0,0,0
2022-04-07 02:45,2,0,2,0,0,0
2022-04-07 03:00,4,0,4,0,0,0
2022-04-07 03:15,4,0,4,0,0,0
2022-04-07 03:30,8,1,7,0,0,0
2022-04-07 03:45,5,1,4,0,0,0
2022-04-07 04:00,8,1,7,0,0,0
2022-04-07 04:15,8,1,7,0,0,0
2022-04-07 04:30,3,1,2,0,0,0
2022-04-07 04:45,2,1,1,0,0,0
2022-04-07 05:00,3,1,2,0,0,0
2022-04-07 05:15,5,1,4,0,0,0
2022-04-07 05:30,9,2,7,0,0,0
2022-04-07 05:45,10,2,8,0,0,0
2022-04-07 06:00,4,2,2,0,0,0
2022-04-07 06:15,12,7,5,0,0,0
2022-04-07 06:30,21,9,12,0,0,0
2022-04-07 06:45,48,9,39,0,0,0
2022-04-07 07:00,54,21,33,0,0,0
2022-04-07 07:15,89,41,48,0,0,0
2022-04-07 07:30,195,127,68,0,0,0
2022-04-07 07:45,181,71,110,0,0,0
2022-04-07 08:00,186,54,132,0,0,0
2022-04-07 08:15,82,34,48,0,0,0
2022-04-07 08:30,75,41,34,0,0,0
2022-04-07 08:45,83,39,44,0,0,0
2022-04-07 09:00,48,15,33,0,0,0
2022-04-07 09:15,38,16,22,0,0,0
2022-04-07 09:30,53,29,24,0,0,0
2022-04-07 09:45,93,38,55,0,0,0
2022-04-07 10:00,96,40,56,0,0,0
2022-04-07 10:15,38,20,18,0,0,0
2022-04-07 10:30,39,20,19,0,0,0
2022-04-07 10:45,36,13,23,0,0,0
2022-04-07 11:00,31,19,12,0,0,0
2022-04-07 11:15,26,12,14,0,0,0
2022-04-07 11:30,33,19,14,0,0,0
2022-04-07 11:45,74,35,39,0,0,0
2022-04-07 12:00,87,49,38,0,0,0
2022-04-07 12:15,69,35,34,0,0,0
2022-04-07 12:30,85,35,50,0,0,0
2022-04-07 12:45,58,24,34,0,0,0
2022-04-07 13:00,84,26,58,0,0,0
2022-04-07 13:15,67,27,40,0,0,0
2022-04-07 13:30,61,28,33,0,0,0
2022-04-07 13:45,110,56,54,0,0,0
2022-04-07 14:00,126,46,80,0,0,0
2022-04-07 14:15,86,54,32,0,0,0
2022-04-07 14:30,67,31,36,0,0,0
2022-04-07 14:45,84,49,35,0,0,0
2022-04-07 15:00,67,45,22,0,0,0
2022-04-07 15:15,60,35,25,0,0,0
2022-04-07 15:30,98,40,58,0,0,0
2022-04-07 15:45,133,77,56,0,0,0
2022-04-07 16:00,123,76,47,0,0,0
2022-04-07 16:15,97,55,42,0,0,0
2022-04-07 16:30,92,52,40,0,0,0
2022-04-07 16:45,118,74,44,0,0,0
2022-04-07 17:00,107,64,43,0,0,0
2022-04-07 17:15,108,54,54,0,0,0
2022-04-07 17:30,75,38,37,0,0,0
2022-04-07 17:45,77,44,33,0,0,0
2022-04-07 18:00,68,23,45,0,0,0
2022-04-07 18:15,59,35,24,0,0,0
2022-04-07 18:30,60,31,29,0,0,0
2022-04-07 18:45,46,21,25,0,0,0
2022-04-07 19:00,52,27,25,0,0,0
2022-04-07 19:15,39,14,25,0,0,0
2022-04-07 19:30,42,17,25,0,0,0
2022-04-07 19:45,45,19,26,0,0,0
2022-04-07 20:00,28,10,18,0,0,0
2022-04-07 20:15,31,13,18,0,0,0
2022-04-07 20:30,24,6,18,0,0,0
2022-04-07 20:45,19,8,11,0,0,0
2022-04-07 21:00,16,4,12,0,0,0
2022-04-07 21:15,22,12,10,0,0,0
2022-04-07 21:30,11,6,5,0,0,0
2022-04-07 21:45,21,13,8,0,0,0
2022-04-07 22:00,16,6,10,0,0,0
2022-04-07 22:15,20,8,12,0,0,0
2022-04-07 22:30,13,4,9,0,0,0
2022-04-07 22:45,13,5,8,0,0,0
2022-04-07 23:00,14,4,10,0,0,0
2022-04-07 23:15,18,5,13,0,0,0
2022-04-07 23:30,13,3,10,0,0,0
2022-04-07 23:45,7,6,1,0,0,0
2022-04-08 00:00,8,2,6,0,0,0
2022-04-08 00:15,12,3,9,0,0,0
2022-04-08 00:30,6,5,1,0,0,0
2022-04-08 00:45,7,0,7,0,0,0
2022-04-08 01:00,6,3,3,0,0,0
2022-04-08 01:15,5,0,5,0,0,0
2022-04-08 01:30,6,2,4,0,0,0
2022-04-08 01:45,5,0,5,0,0,0
2022-04-08 02:00,8,0,8,0,0,0
2022-04-08 02:15,2,0,2,0,0,0
2022-04-08 02:30,6,0,6,0,0,0
2022-04-08 02:45,6,0,6,0,0,0
2022-04-08 03:00,0,0,0,0,0,0
2022-04-08 03:15,1,0,1,0,0,0
2022-04-08 03:30,1,0,1,0,0,0
2022-04-08 03:45,3,0,3,0,0,0
2022-04-08 04:00,4,2,2,0,0,0
2022-04-08 04:15,3,2,1,0,0,0
2022-04-08 04:30,5,1,4,0,0,0
2022-04-08 04:45,1,0,1,0,0,0
2022-04-08 05:00,1,0,1,0,0,0
2022-04-08 05:15,3,1,2,0,0,0
2022-04-08 05:30,5,2,3,0,0,0
2022-04-08 05:45,8,3,5,0,0,0
2022-04-08 06:00,6,3,3,0,0,0
2022-04-08 06:15,11,4,7,0,0,0
2022-04-08 06:30,24,13,11,0,0,0
2022-04-08 06:45,42,9,33,0,0,0
2022-04-08 07:00,46,16,30,0,0,0
2022-04-08 07:15,78,44,34,0,0,0
2022-04-08 07:30,197,127,70,0,0,0
2022-04-08 07:45,156,64,92,0,0,0
2022-04-08 08:00,138,42,96,0,0,0
2022-04-08 08:15,97,44,53,0,0,0
2022-04-08 08:30,100,50,50,0,0,0
2022-04-08 08:45,125,62,63,0,0,0
2022-04-08 09:00,95,32,63,0,0,0
2022-04-08 09:15,58,30,28,0,0,0
2022-04-08 09:30,75,34,41,0,0,0
2022-04-08 09:45,127,62,65,0,0,0
2022-04-08 10:00,134,59,75,0,0,0
2022-04-08 10:15,61,30,31,0,0,0
2022-04-08 10:30,72,36,36,0,0,0
2022-04-08 10:45,56,30,26,0,0,0
2022-04-08 11:00,84,47,37,0,0,0
2022-04-08 11:15,61,38,23,0,0,0
2022-04-08 11:30,79,51,28,0,0,0
2022-04-08 11:45,105,39,66,0,0,0
2022-04-08 12:00,106,60,46,0,0,0
2022-04-08 12:15,106,46,60,0,0,0
2022-04-08 12:30,120,50,70,0,0,0
2022-04-08 12:45,100,50,50,0,0,0
2022-04-08 13:00,144,41,103,0,0,0
2022-04-08 13:15,97,21,76,0,0,0
2022-04-08 13:30,112,45,67,0,0,0
2022-04-08 13:45,106,49,57,0,0,0
2022-04-08 14:00,122,66,56,0,0,0
2022-04-08 14:15,101,55,46,0,0,0
2022-04-08 14:30,109,50,59,0,0,0
2022-04-08 14:45,114,55,59,0,0,0
2022-04-08 15:00,93,44,49,0,0,0
2022-04-08 15:15,99,50,49,0,0,0
2022-04-08 15:30,84,27,57,0,0,0
2022-04-08 15:45,105,61,44,0,0,0
2022-04-08 16:00,112,65,47,0,0,0
2022-04-08 16:15,108,53,55,0,0,0
2022-04-08 16:30,110,64,46,0,0,0
2022-04-08 16:45,71,36,35,0,0,0
2022-04-08 17:00,65,31,34,0,0,0
2022-04-08 17:15,83,45,38,0,0,0
2022-04-08 17:30,101,57,44,0,0,0
2022-04-08 17:45,69,30,39,0,0,0
2022-04-08 18:00,59,34,25,0,0,0
2022-04-08 18:15,75,33,42,0,0,0
2022-04-08 18:30,68,35,33,0,0,0
2022-04-08 18:45,88,40,48,0,0,0
2022-04-08 19:00,71,35,36,0,0,0
2022-04-08 19:15,57,20,37,0,0,0
2022-04-08 19:30,39,11,28,0,0,0
2022-04-08 19:45,52,27,25,0,0,0
2022-04-08 20:00,44,18,26,0,0,0
2022-04-08 20:15,40,13,27,0,0,0
2022-04-08 20:30,22,15,7,0,0,0
2022-04-08 20:45,22,14,8,0,0,0
2022-04-08 21:00,19,7,12,0,0,0
2022-04-08 21:15,18,10,8,0,0,0
2022-04-08 21:30,20,9,11,0,0,0
2022-04-08 21:45,23,14,9,0,0,0
2022-04-08 22:00,20,13,7,0,0,0
2022-04-08 22:15,16,8,8,0,0,0
2022-04-08 22:30,20,8,12,0,0,0
2022-04-08 22:45,10,0,10,0,0,0
2022-04-08 23:00,15,0,15,0,0,0
2022-04-08 23:15,21,7,14,0,0,0
2022-04-08 23:30,11,1,10,0,0,0
2022-04-08 23:45,20,4,16,0,0,0
2022-04-09 00:00,6,0,6,0,0,0
2022-04-09 00:15,13,4,9,0,0,0
2022-04-09 00:30,16,7,9,0,0,0
2022-04-09 00:45,7,4,3,0,0,0
2022-04-09 01:00,15,6,9,0,0,0
2022-04-09 01:15,15,11,4,0,0,0
2022-04-09 01:30,7,3,4,0,0,0
2022-04-09 01:45,13,3,10,0,0,0
2022-04-09 02:00,5,0,5,0,0,0
2022-04-09 02:15,7,0,7,0,0,0
2022-04-09 02:30,6,2,4,0,0,0
2022-04-09 02:45,3,2,1,0,0,0
2022-04-09 03:00,7,5,2,0,0,0
2022-04-09 03:15,7,0,7,0,0,0
2022-04-09 03:30,8,0,8,0,0,0
2022-04-09 03:45,8,1,7,0,0,0
2022-04-09 04:00,5,2,3,0,0,0
2022-04-09 04:15,9,0,9,0,0,0
2022-04-09 04:30,6,1,5,0,0,0
2022-04-09 04:45,6,0,6,0,0,0
2022-04-09 05:00,9,1,8,0,0,0
2022-04-09 05:15,4,2,2,0,0,0
2022-04-09 05:30,3,2,1,0,0,0
2022-04-09 05:45,5,0,5,0,0,0
2022-04-09 06:00,4,3,1,0,0,0
2022-04-09 06:15,3,1,2,0,0,0
2022-04-09 06:30,3,2,1,0,0,0
2022-04-09 06:45,9,9,0,0,0,0
2022-04-09 07:00,7,5,2,0,0,0
2022-04-09 07:15,7,4,3,0,0,0
2022-04-09 07:30,22,8,14,0,0,0
2022-04-09 07:45,28,18,10,0,0,0
2022-04-09 08:00,20,6,14,0,0,0
2022-04-09 08:15,14,7,7,0,0,0
2022-04-09 08:30,13,10,3,0,0,0
2022-04-09 08:45,24,15,9,0,0,0
2022-04-09 09:00,27,17,10,0,0,0
2022-04-09 09:15,27,17,10,0,0,0
2022-04-09 09:30,39,28,11,0,0,0
2022-04-09 09:45,33,26,7,0,0,0
2022-04-09 10:00,31,22,9,0,0,0
2022-04-09 10:15,60,38,22,0,0,0
2022-04-09 10:30,63,44,19,0,0,0
2022-04-09 10:45,34,21,13,0,0,0
2022-04-09 11:00,53,31,22,0,0,0
2022-04-09 11:15,57,30,27,0,0,0
2022-04-09 11:30,35,16,19,0,0,0
2022-04-09 11:45,69,43,26,0,0,0
2022-04-09 12:00,38,20,18,0,0,0
2022-04-09 12:15,58,30,28,0,0,0
2022-04-09 12:30,48,31,17,0,0,0
2022-04-09 12:45,39,17,22,0,0,0
2022-04-09 13:00,67,35,32,0,0,0
2022-04-09 13:15,54,23,31,0,0,0
2022-04-09 13:30,57,27,30,0,0,0
2022-04-09 13:45,61,31,30,0,0,0
2022-04-09 14:00,51,24,27,0,0,0
2022-04-09 14:15,33,13,20,0,0,0
2022-04-09 14:30,43,16,27,0,0,0
2022-04-09 14:45,38,11,27,0,0,0
2022-04-09 15:00,33,12,21,0,0,0
2022-04-09 15:15,24,12,12,0,0,0
2022-04-09 15:30,42,17,25,0,0,0
2022-04-09 15:45,32,12,20,0,0,0
2022-04-09 16:00,25,10,15,0,0,0
2022-04-09 16:15,43,19,24,0,0,0
2022-04-09 16:30,25,13,12,0,0,0
2022-04-09 16:45,22,6,16,0,0,0
2022-04-09 17:00,33,10,23,0,0,0
2022-04-09 17:15,21,3,18,0,0,0
2022-04-09 17:30,33,9,24,0,0,0
2022-04-09 17:45,26,9,17,0,0,0
2022-04-09 18:00,30,13,17,0,0,0
2022-04-09 18:15,22,6,16,0,0,0
2022-04-09 18:30,25,7,18,0,0,0
2022-04-09 18:45,17,9,8,0,0,0
2022-04-09 19:00,25,14,11,0,0,0
2022-04-09 19:15,23,9,14,0,0,0
2022-04-09 19:30,33,15,18,0,0,0
2022-04-09 19:45,29,16,13,0,0,0
2022-04-09 20:00,34,13,21,0,0,0
2022-04-09 20:15,24,11,13,0,0,0
2022-04-09 20:30,10,7,3,0,0,0
2022-04-09 20:45,8,7,1,0,0,0
2022-04-09 21:00,35,18,17,0,0,0
2022-04-09 21:15,9,3,6,0,0,0
2022-04-09 21:30,9,5,4,0,0,0
2022-04-09 21:45,15,5,10,0,0,0
2022-04-09 22:00,19,10,9,0,0,0
2022-04-09 22:15,12,6,6,0,0,0
2022-04-09 22:30,9,6,3,0,0,0
2022-04-09 22:45,10,2,8,0,0,0
2022-04-09 23:00,10,2,8,0,0,0
2022-04-09 23:15,10,4,6,0,0,0
2022-04-09 23:30,14,3,11,0,0,0
2022-04-09 23:45,18,4,14,0,0,0
2022-04-10 00:00,7,3,4,0,0,0
2022-04-10 00:15,5,0,5,0,0,0
2022-04-10 00:30,4,1,3,0,0,0
2022-04-10 00:45,5,3,2,0,0,0
2022-04-10 01:00,11,0,11,0,0,0
2022-04-10 01:15,8,2,6,0,0,0
2022-04-10 01:30,1,0,1,0,0,0
2022-04-10 01:45,4,1,3,0,0,0
2022-04-10 02:00,1,0,1,0,0,0
2022-04-10 02:15,6,1,5,0,0,0
2022-04-10 02:30,3,0,3,0,0,0
2022-04-10 02:45,7,1,6,0,0,0
2022-04-10 03:00,3,3,0,0,0,0
2022-04-10 03:15,5,1,4,0,0,0
2022-04-10 03:30,3,2,1,0,0,0
2022-04-10 03:45,3,1,2,0,0,0
2022-04-10 04:00,2,1,1,0,0,0
2022-04-10 04:15,5,0,5,0,0,0
2022-04-10 04:30,4,1,3,0,0,0
2022-04-10 04:45,3,0,3,0,0,0
2022-04-10 05:00,3,1,2,0,0,0
2022-04-10 05:15,1,1,0,0,0,0
2022-04-10 05:30,7,2,5,0,0,0
2022-04-10 05:45,2,0,2,0,0,0
2022-04-10 06:00,1,1,0,0,0,0
2022-04-10 06:15,1,1,0,0,0,0
2022-04-10 06:30,3,1,2,0,0,0
2022-04-10 06:45,1,1,0,0,0,0
2022-04-10 07:00,9,1,8,0,0,0
2022-04-10 07:15,6,4,2,0,0,0
2022-04-10 07:30,9,4,5,0,0,0
2022-04-10 07:45,8,3,5,0,0,0
2022-04-10 08:00,4,2,2,0,0,0
2022-04-10 08:15,8,8,0,0,0,0
2022-04-10 08:30,6,3,3,0,0,0
2022-04-10 08:45,12,11,1,0,0,0
2022-04-10 09:00,11,9,2,0,0,0
2022-04-10 09:15,14,8,6,0,0,0
2022-04-10 09:30,24,11,13,0,0,0
2022-04-10 09:45,25,18,7,0,0,0
2022-04-10 10:00,14,6,8,0,0,0
2022-04-10 10:15,19,12,7,0,0,0
2022-04-10 10:30,21,7,14,0,0,0
2022-04-10 10:45,29,20,9,0,0,0
2022-04-10 11:00,31,18,13,0,0,0
2022-04-10 11:15,32,17,15,0,0,0
2022-04-10 11:30,25,16,9,0,0,0
2022-04-10 11:45,25,13,12,0,0,0
2022-04-10 12:00,34,21,13,0,0,0
2022-04-10 12:15,34,14,20,0,0,0
2022-04-10 12:30,36,16,20,0,0,0
2022-04-10 12:45,43,28,15,0,0,0
2022-04-10 13:00,39,25,14,0,0,0
2022-04-10 13:15,26,10,16,0,0,0
2022-04-10 13:30,23,2,21,0,0,0
2022-04-10 13:45,39,17,22,0,0,0
2022-04-10 14:00,29,13,16,0,0,0
2022-04-10 14:15,37,8,29,0,0,0
2022-04-10 14:30,35,20,15,0,0,0
2022-04-10 14:45,39,26,13,0,0,0
2022-04-10 15:00,29,15,14,0,0,0
2022-04-10 15:15,30,10,20,0,0,0
2022-04-10 15:30,38,16,22,0,0,0
2022-04-10 15:45,35,24,11,0,0,0
2022-04-10 16:00,43,14,29,0,0,0
2022-04-10 16:15,35,17,18,0,0,0
2022-04-10 16:30,39,25,14,0,0,0
2022-04-10 16:45,35,16,19,0,0,0
2022-04-10 17:00,37,11,26,0,0,0
2022-04-10 17:15,36,19,17,0,0,0
2022-04-10 17:30,37,20,17,0,0,0
2022-04-10 17:45,33,6,27,0,0,0
2022-04-10 18:00,33,6,27,0,0,0
2022-04-10 18:15,61,23,38,0,0,0
2022-04-10 18:30,36,19,17,0,0,0
2022-04-10 18:45,28,13,15,0,0,0
2022-04-10 19:00,40,18,22,0,0,0
2022-04-10 19:15,24,16,8,0,0,0
2022-04-10 19:30,11,2,9,0,0,0
2022-04-10 19:45,42,9,33,0,0,0
2022-04-10 20:00,25,5,20,0,0,0
2022-04-10 20:15,19,7,12,0,0,0
2022-04-10 20:30,13,4,9,0,0,0
2022-04-10 20:45,17,9,8,0,0,0
2022-04-10 21:00,17,8,9,0,0,0
2022-04-10 21:15,18,9,9,0,0,0
2022-04-10 21:30,12,6,6,0,0,0
2022-04-10 21:45,19,8,11,0,0,0
2022-04-10 22:00,13,2,11,0,0,0
2022-04-10 22:15,9,0,9,0,0,0
2022-04-10 22:30,7,3,4,0,0,0
2022-04-10 22:45,5,1,4,0,0,0
2022-04-10 23:00,15,2,13,0,0,0
2022-04-10 23:15,5,2,3,0,0,0
2022-04-10 23:30,9,1,8,0,0,0
2022-04-10 23:45,3,0,3,0,0,0
2022-04-11 00:00,0,0,0,0,0,0
2022-04-11 00:15,5,3,2,0,0,0
2022-04-11 00:30,3,1,2,0,0,0
2022-04-11 00:45,1,0,1,0,0,0
2022-04-11 01:00,1,0,1,0,0,0
2022-04-11 01:15,0,0,0,0,0,0
2022-04-11 01:30,3,0,3,0,0,0
2022-04-11 01:45,0,0,0,0,0,0
2022-04-11 02:00,1,1,0,0,0,0
2022-04-11 02:15,2,0,2,0,0,0
2022-04-11 02:30,1,1,0,0,0,0
2022-04-11 02:45,3,2,1,0,0,0
2022-04-11 03:00,3,3,0,0,0,0
2022-04-11 03:15,1,1,0,0,0,0
2022-04-11 03:30,0,0,0,0,0,0
2022-04-11 03:45,0,0,0,0,0,0
2022-04-11 04:00,1,0,1,0,0,0
2022-04-11 04:15,0,0,0,0,0,0
2022-04-11 04:30,3,0,3,0,0,0
2022-04-11 04:45,0,0,0,0,0,0
2022-04-11 05:00,0,0,0,0,0,0
2022-04-11 05:15,3,1,2,0,0,0
2022-04-11 05:30,7,3,4,0,0,0
2022-04-11 05:45,8,5,3,0,0,0
2022-04-11 06:00,6,2,4,0,0,0
2022-04-11 06:15,20,9,11,0,0,0
2022-04-11 06:30,34,10,24,0,0,0
2022-04-11 06:45,46,15,31,0,0,0
2022-04-11 07:00,55,14,41,0,0,0
2022-04-11 07:15,70,29,41,0,0,0
2022-04-11 07:30,78,28,50,0,0,0
2022-04-11 07:45,157,55,102,0,0,0
2022-04-11 08:00,158,49,109,0,0,0
2022-04-11 08:15,92,36,56,0,0,0
2022-04-11 08:30,94,53,41,0,0,0
2022-04-11 08:45,96,47,49,0,0,0
2022-04-11 09:00,92,36,56,0,0,0
2022-04-11 09:15,73,43,30,0,0,0
2022-04-11 09:30,89,42,47,0,0,0
2022-04-11 09:45,185,89,96,0,0,0
2022-04-11 10:00,153,69,84,0,0,0
2022-04-11 10:15,71,48,23,0,0,0
2022-04-11 10:30,48,22,26,0,0,0
2022-04-11 10:45,72,37,35,0,0,0
2022-04-11 11:00,62,36,26,0,0,0
2022-04-11 11:15,76,41,35,0,0,0
2022-04-11 11:30,72,34,38,0,0,0
2022-04-11 11:45,208,110,98,0,0,0
2022-04-11 12:00,124,70,54,0,0,0
2022-04-11 12:15,99,39,60,0,0,0
2022-04-11 12:30,76,34,42,0,0,0
2022-04-11 12:45,86,40,46,0,0,0
2022-04-11 13:00,128,79,49,0,0,0
2022-04-11 13:15,75,41,34,0,0,0
2022-04-11 13:30,84,36,48,0,0,0
2022-04-11 13:45,196,87,109,0,0,0
2022-04-11 14:00,136,69,67,0,0,0
2022-04-11 14:15,91,41,50,0,0,0
2022-04-11 14:30,85,43,42,0,0,0
2022-04-11 14:45,103,50,53,0,0,0
2022-04-11 15:00,106,57,49,0,0,0
2022-04-11 15:15,121,67,54,0,0,0
2022-04-11 15:30,132,80,52,0,0,0
2022-04-11 15:45,250,137,113,0,0,0
2022-04-11 16:00,197,125,72,0,0,0
2022-04-11 16:15,135,73,62,0,0,0
2022-04-11 16:30,136,74,62,0,0,0
2022-04-11 16:45,128,78,50,0,0,0
2022-04-11 17:00,127,66,61,0,0,0
2022-04-11 17:15,139,71,68,0,0,0
2022-04-11 17:30,130,71,59,0,0,0
2022-04-11 17:45,198,100,98,0,0,0
2022-04-11 18:00,122,51,71,0,0,0
2022-04-11 18:15,114,61,53,0,0,0
2022-04-11 18:30,92,47,45,0,0,0
2022-04-11 18:45,78,42,36,0,0,0
2022-04-11 19:00,51,16,35,0,0,0
2022-04-11 19:15,69,26,43,0,0,0
2022-04-11 19:30,61,23,38,0,0,0
2022-04-11 19:45,74,20,54,0,0,0
2022-04-11 20:00,66,16,50,0,0,0
2022-04-11 20:15,39,11,28,0,0,0
2022-04-11 20:30,30,4,26,0,0,0
2022-04-11 20:45,34,8,26,0,0,0
2022-04-11 21:00,31,8,23,0,0,0
2022-04-11 21:15,28,16,12,0,0,0
2022-04-11 21:30,18,4,14,0,0,0
2022-04-11 21:45,29,9,20,0,0,0
2022-04-11 22:00,24,2,22,0,0,0
2022-04-11 22:15,31,7,24,0,0,0
2022-04-11 22:30,18,7,11,0,0,0
2022-04-11 22:45,28,6,22,0,0,0
2022-04-11 23:00,22,2,20,0,0,0
2022-04-11 23:15,13,2,11,0,0,0
2022-04-11 23:30,7,1,6,0,0,0
2022-04-11 23:45,5,0,5,0,0,0
2022-04-12 00:00,8,4,4,0,0,0
2022-04-12 00:15,4,0,4,0,0,0
2022-04-12 00:30,3,0,3,0,0,0
2022-04-12 00:45,2,0,2,0,0,0
2022-04-12 01:00,4,1,3,0,0,0
2022-04-12 01:15,1,1,0,0,0,0
2022-04-12 01:30,0,0,0,0,0,0
2022-04-12 01:45,1,1,0,0,0,0
2022-04-12 02:00,1,1,0,0,0,0
2022-04-12 02:15,1,0,1,0,0,0
2022-04-12 02:30,1,0,1,0,0,0
2022-04-12 02:45,0,0,0,0,0,0
2022-04-12 03:00,0,0,0,0,0,0
2022-04-12 03:15,2,0,2,0,0,0
2022-04-12 03:30,1,0,1,0,0,0
2022-04-12 03:45,0,0,0,0,0,0
2022-04-12 04:00,3,0,3,0,0,0
2022-04-12 04:15,0,0,0,0,0,0
2022-04-12 04:30,1,1,0,0,0,0
2022-04-12 04:45,0,0,0,0,0,0
2022-04-12 05:00,2,2,0,0,0,0
2022-04-12 05:15,2,1,1,0,0,0
2022-04-12 05:30,11,5,6,0,0,0
2022-04-12 05:45,7,4,3,0,0,0
2022-04-12 06:00,10,4,6,0,0,0
2022-04-12 06:15,24,7,17,0,0,0
2022-04-12 06:30,36,11,25,0,0,0
2022-04-12 06:45,40,14,26,0,0,0
2022-04-12 07:00,64,27,37,0,0,0
2022-04-12 07:15,71,36,35,0,0,0
2022-04-12 07:30,101,37,64,0,0,0
2022-04-12 07:45,196,71,125,0,0,0
2022-04-12 08:00,197,71,126,0,0,0
2022-04-12 08:15,113,47,66,0,0,0
2022-04-12 08:30,101,50,51,0,0,0
2022-04-12 08:45,124,61,63,0,0,0
2022-04-12 09:00,84,39,45,0,0,0
2022-04-12 09:15,83,45,38,0,0,0
2022-04-12 09:30,112,42,70,0,0,0
2022-04-12 09:45,173,89,84,0,0,0
2022-04-12 10:00,178,75,103,0,0,0
2022-04-12 10:15,73,43,30,0,0,0
2022-04-12 10:30,46,23,23,0,0,0
2022-04-12 10:45,87,54,33,0,0,0
2022-04-12 11:00,69,33,36,0,0,0
2022-04-12 11:15,73,41,32,0,0,0
2022-04-12 11:30,86,46,40,0,0,0
2022-04-12 11:45,214,130,84,0,0,0
2022-04-12 12:00,148,76,72,0,0,0
2022-04-12 12:15,124,56,68,0,0,0
2022-04-12 12:30,96,48,48,0,0,0
2022-04-12 12:45,90,53,37,0,0,0
2022-04-12 13:00,124,63,61,0,0,0
2022-04-12 13:15,107,43,64,0,0,0
2022-04-12 13:30,126,64,62,0,0,0
2022-04-12 13:45,207,109,98,0,0,0
2022-04-12 14:00,189,93,96,0,0,0
2022-04-12 14:15,91,52,39,0,0,0
2022-04-12 14:30,106,48,58,0,0,0
2022-04-12 14:45,117,68,49,0,0,0
2022-04-12 15:00,103,58,45,0,0,0
2022-04-12 15:15,108,60,48,0,0,0
2022-04-12 15:30,127,61,66,0,0,0
2022-04-12 15:45,246,134,112,0,0,0
2022-04-12 16:00,233,128,105,0,0,0
2022-04-12 16:15,137,63,74,0,0,0
2022-04-12 16:30,128,77,51,0,0,0
2022-04-12 16:45,132,78,54,0,0,0
2022-04-12 17:00,145,69,76,0,0,0
2022-04-12 17:15,159,88,71,0,0,0
2022-04-12 17:30,159,71,88,0,0,0
2022-04-12 17:45,170,90,80,0,0,0
2022-04-12 18:00,139,82,57,0,0,0
2022-04-12 18:15,130,72,58,0,0,0
2022-04-12 18:30,83,30,53,0,0,0
2022-04-12 18:45,95,36,59,0,0,0
2022-04-12 19:00,82,35,47,0,0,0
2022-04-12 19:15,74,39,35,0,0,0
2022-04-12 19:30,90,35,55,0,0,0
2022-04-12 19:45,77,32,45,0,0,0
2022-04-12 20:00,71,20,51,0,0,0
2022-04-12 20:15,47,19,28,0,0,0
2022-04-12 20:30,47,9,38,0,0,0
2022-04-12 20:45,59,22,37,0,0,0
2022-04-12 21:00,47,16,31,0,0,0
2022-04-12 21:15,38,13,25,0,0,0
2022-04-12 21:30,19,7,12,0,0,0
2022-04-12 21:45,43,6,37,0,0,0
2022-04-12 22:00,34,10,24,0,0,0
2022-04-12 22:15,34,10,24,0,0,0
2022-04-12 22:30,18,4,14,0,0,0
2022-04-12 22:45,22,1,21,0,0,0
2022-04-12 23:00,19,3,16,0,0,0
2022-04-12 23:15,17,4,13,0,0,0
2022-04-12 23:30,24,15,9,0,0,0
2022-04-12 23:45,17,4,13,0,0,0
