Datetime,100031300 (HafenstraÃŸe),101031300 (Channel 1 IN),102031300 (Channel 2 OUT),100031300-status,101031300-status,102031300-status
2022-02-01 00:00,10,5,5,0,0,0
2022-02-01 00:15,5,4,1,0,0,0
2022-02-01 00:30,2,1,1,0,0,0
2022-02-01 00:45,8,1,7,0,0,0
2022-02-01 01:00,4,0,4,0,0,0
2022-02-01 01:15,2,1,1,0,0,0
2022-02-01 01:30,1,1,0,0,0,0
2022-02-01 01:45,1,1,0,0,0,0
2022-02-01 02:00,1,0,1,0,0,0
2022-02-01 02:15,4,2,2,0,0,0
2022-02-01 02:30,0,0,0,0,0,0
2022-02-01 02:45,2,2,0,0,0,0
2022-02-01 03:00,3,2,1,0,0,0
2022-02-01 03:15,1,0,1,0,0,0
2022-02-01 03:30,1,1,0,0,0,0
2022-02-01 03:45,1,0,1,0,0,0
2022-02-01 04:00,0,0,0,0,0,0
2022-02-01 04:15,5,1,4,0,0,0
2022-02-01 04:30,2,1,1,0,0,0
2022-02-01 04:45,5,3,2,0,0,0
2022-02-01 05:00,1,1,0,0,0,0
2022-02-01 05:15,6,3,3,0,0,0
2022-02-01 05:30,12,6,6,0,0,0
2022-02-01 05:45,17,7,10,0,0,0
2022-02-01 06:00,13,3,10,0,0,0
2022-02-01 06:15,26,8,18,0,0,0
2022-02-01 06:30,42,15,27,0,0,0
2022-02-01 06:45,56,30,26,0,0,0
2022-02-01 07:00,74,35,39,0,0,0
2022-02-01 07:15,90,39,51,0,0,0
2022-02-01 07:30,133,56,77,0,0,0
2022-02-01 07:45,123,70,53,0,0,0
2022-02-01 08:00,123,57,66,0,0,0
2022-02-01 08:15,111,46,65,0,0,0
2022-02-01 08:30,135,60,75,0,0,0
2022-02-01 08:45,121,59,62,0,0,0
2022-02-01 09:00,85,28,57,0,0,0
2022-02-01 09:15,93,38,55,0,0,0
2022-02-01 09:30,73,33,40,0,0,0
2022-02-01 09:45,110,43,67,0,0,0
2022-02-01 10:00,73,25,48,0,0,0
2022-02-01 10:15,79,29,50,0,0,0
2022-02-01 10:30,47,19,28,0,0,0
2022-02-01 10:45,73,34,39,0,0,0
2022-02-01 11:00,64,22,42,0,0,0
2022-02-01 11:15,62,23,39,0,0,0
2022-02-01 11:30,81,40,41,0,0,0
2022-02-01 11:45,82,39,43,0,0,0
2022-02-01 12:00,81,42,39,0,0,0
2022-02-01 12:15,85,41,44,0,0,0
2022-02-01 12:30,92,44,48,0,0,0
2022-02-01 12:45,98,37,61,0,0,0
2022-02-01 13:00,115,53,62,0,0,0
2022-02-01 13:15,86,38,48,0,0,0
2022-02-01 13:30,86,41,45,0,0,0
2022-02-01 13:45,93,44,49,0,0,0
2022-02-01 14:00,116,55,61,0,0,0
2022-02-01 14:15,112,52,60,0,0,0
2022-02-01 14:30,92,35,57,0,0,0
2022-02-01 14:45,107,47,60,0,0,0
2022-02-01 15:00,96,43,53,0,0,0
2022-02-01 15:15,88,40,48,0,0,0
2022-02-01 15:30,97,40,57,0,0,0
2022-02-01 15:45,105,50,55,0,0,0
2022-02-01 16:00,103,43,60,0,0,0
2022-02-01 16:15,122,60,62,0,0,0
2022-02-01 16:30,105,45,60,0,0,0
2022-02-01 16:45,115,51,64,0,0,0
2022-02-01 17:00,121,58,63,0,0,0
2022-02-01 17:15,134,56,78,0,0,0
2022-02-01 17:30,106,40,66,0,0,0
2022-02-01 17:45,134,63,71,0,0,0
2022-02-01 18:00,134,66,68,0,0,0
2022-02-01 18:15,116,60,56,0,0,0
2022-02-01 18:30,115,61,54,0,0,0
2022-02-01 18:45,109,60,49,0,0,0
2022-02-01 19:00,101,50,51,0,0,0
2022-02-01 19:15,99,48,51,0,0,0
2022-02-01 19:30,85,30,55,0,0,0
2022-02-01 19:45,61,38,23,0,0,0
2022-02-01 20:00,68,24,44,0,0,0
2022-02-01 20:15,70,35,35,0,0,0
2022-02-01 20:30,46,19,27,0,0,0
2022-02-01 20:45,40,10,30,0,0,0
2022-02-01 21:00,53,16,37,0,0,0
2022-02-01 21:15,44,22,22,0,0,0
2022-02-01 21:30,36,16,20,0,0,0
2022-02-01 21:45,34,13,21,0,0,0
2022-02-01 22:00,31,13,18,0,0,0
2022-02-01 22:15,37,16,21,0,0,0
2022-02-01 22:30,28,9,19,0,0,0
2022-02-01 22:45,35,13,22,0,0,0
2022-02-01 23:00,23,5,18,0,0,0
2022-02-01 23:15,17,3,14,0,0,0
2022-02-01 23:30,18,8,10,0,0,0
2022-02-01 23:45,17,6,11,0,0,0
2022-02-02 00:00,6,3,3,0,0,0
2022-02-02 00:15,9,4,5,0,0,0
2022-02-02 00:30,6,3,3,0,0,0
2022-02-02 00:45,3,2,1,0,0,0
2022-02-02 01:00,3,0,3,0,0,0
2022-02-02 01:15,4,2,2,0,0,0
2022-02-02 01:30,2,0,2,0,0,0
2022-02-02 01:45,1,0,1,0,0,0
2022-02-02 02:00,7,1,6,0,0,0
2022-02-02 02:15,2,1,1,0,0,0
2022-02-02 02:30,1,0,1,0,0,0
2022-02-02 02:45,4,1,3,0,0,0
2022-02-02 03:00,0,0,0,0,0,0
2022-02-02 03:15,0,0,0,0,0,0
2022-02-02 03:30,0,0,0,0,0,0
2022-02-02 03:45,0,0,0,0,0,0
2022-02-02 04:00,2,1,1,0,0,0
2022-02-02 04:15,3,0,3,0,0,0
2022-02-02 04:30,6,5,1,0,0,0
2022-02-02 04:45,1,0,1,0,0,0
2022-02-02 05:00,8,0,8,0,0,0
2022-02-02 05:15,8,3,5,0,0,0
2022-02-02 05:30,17,6,11,0,0,0
2022-02-02 05:45,28,9,19,0,0,0
2022-02-02 06:00,16,4,12,0,0,0
2022-02-02 06:15,44,12,32,0,0,0
2022-02-02 06:30,47,17,30,0,0,0
2022-02-02 06:45,49,22,27,0,0,0
2022-02-02 07:00,81,38,43,0,0,0
2022-02-02 07:15,87,44,43,0,0,0
2022-02-02 07:30,153,70,83,0,0,0
2022-02-02 07:45,138,65,73,0,0,0
2022-02-02 08:00,102,48,54,0,0,0
2022-02-02 08:15,130,56,74,0,0,0
2022-02-02 08:30,119,52,67,0,0,0
2022-02-02 08:45,119,62,57,0,0,0
2022-02-02 09:00,79,31,48,0,0,0
2022-02-02 09:15,87,37,50,0,0,0
2022-02-02 09:30,80,30,50,0,0,0
2022-02-02 09:45,93,38,55,0,0,0
2022-02-02 10:00,64,28,36,0,0,0
2022-02-02 10:15,83,35,48,0,0,0
2022-02-02 10:30,62,23,39,0,0,0
2022-02-02 10:45,79,36,43,0,0,0
2022-02-02 11:00,76,23,53,0,0,0
2022-02-02 11:15,82,24,58,0,0,0
2022-02-02 11:30,91,48,43,0,0,0
2022-02-02 11:45,91,38,53,0,0,0
2022-02-02 12:00,95,32,63,0,0,0
2022-02-02 12:15,101,37,64,0,0,0
2022-02-02 12:30,89,45,44,0,0,0
2022-02-02 12:45,118,56,62,0,0,0
2022-02-02 13:00,104,56,48,0,0,0
2022-02-02 13:15,110,52,58,0,0,0
2022-02-02 13:30,123,61,62,0,0,0
2022-02-02 13:45,129,62,67,0,0,0
2022-02-02 14:00,127,73,54,0,0,0
2022-02-02 14:15,90,49,41,0,0,0
2022-02-02 14:30,106,55,51,0,0,0
2022-02-02 14:45,113,60,53,0,0,0
2022-02-02 15:00,86,37,49,0,0,0
2022-02-02 15:15,104,55,49,0,0,0
2022-02-02 15:30,121,65,56,0,0,0
2022-02-02 15:45,134,61,73,0,0,0
2022-02-02 16:00,125,59,66,0,0,0
2022-02-02 16:15,149,72,77,0,0,0
2022-02-02 16:30,146,78,68,0,0,0
2022-02-02 16:45,148,67,81,0,0,0
2022-02-02 17:00,143,60,83,0,0,0
2022-02-02 17:15,162,78,84,0,0,0
2022-02-02 17:30,142,69,73,0,0,0
2022-02-02 17:45,166,85,81,0,0,0
2022-02-02 18:00,136,65,71,0,0,0
2022-02-02 18:15,124,63,61,0,0,0
2022-02-02 18:30,118,56,62,0,0,0
2022-02-02 18:45,139,73,66,0,0,0
2022-02-02 19:00,114,55,59,0,0,0
2022-02-02 19:15,100,60,40,0,0,0
2022-02-02 19:30,85,44,41,0,0,0
2022-02-02 19:45,97,52,45,0,0,0
2022-02-02 20:00,84,40,44,0,0,0
2022-02-02 20:15,70,34,36,0,0,0
2022-02-02 20:30,52,30,22,0,0,0
2022-02-02 20:45,52,20,32,0,0,0
2022-02-02 21:00,33,12,21,0,0,0
2022-02-02 21:15,46,17,29,0,0,0
2022-02-02 21:30,41,17,24,0,0,0
2022-02-02 21:45,38,12,26,0,0,0
2022-02-02 22:00,38,19,19,0,0,0
2022-02-02 22:15,42,13,29,0,0,0
2022-02-02 22:30,36,10,26,0,0,0
2022-02-02 22:45,45,15,30,0,0,0
2022-02-02 23:00,39,9,30,0,0,0
2022-02-02 23:15,24,6,18,0,0,0
2022-02-02 23:30,25,11,14,0,0,0
2022-02-02 23:45,21,14,7,0,0,0
2022-02-03 00:00,14,11,3,0,0,0
2022-02-03 00:15,10,4,6,0,0,0
2022-02-03 00:30,5,1,4,0,0,0
2022-02-03 00:45,7,4,3,0,0,0
2022-02-03 01:00,4,2,2,0,0,0
2022-02-03 01:15,8,3,5,0,0,0
2022-02-03 01:30,3,2,1,0,0,0
2022-02-03 01:45,1,1,0,0,0,0
2022-02-03 02:00,4,3,1,0,0,0
2022-02-03 02:15,4,3,1,0,0,0
2022-02-03 02:30,2,1,1,0,0,0
2022-02-03 02:45,1,0,1,0,0,0
2022-02-03 03:00,2,2,0,0,0,0
2022-02-03 03:15,2,2,0,0,0,0
2022-02-03 03:30,0,0,0,0,0,0
2022-02-03 03:45,0,0,0,0,0,0
2022-02-03 04:00,3,2,1,0,0,0
2022-02-03 04:15,1,0,1,0,0,0
2022-02-03 04:30,3,1,2,0,0,0
2022-02-03 04:45,6,2,4,0,0,0
2022-02-03 05:00,4,1,3,0,0,0
2022-02-03 05:15,4,1,3,0,0,0
2022-02-03 05:30,20,8,12,0,0,0
2022-02-03 05:45,19,11,8,0,0,0
2022-02-03 06:00,11,4,7,0,0,0
2022-02-03 06:15,33,9,24,0,0,0
2022-02-03 06:30,52,16,36,0,0,0
2022-02-03 06:45,53,26,27,0,0,0
2022-02-03 07:00,71,36,35,0,0,0
2022-02-03 07:15,78,35,43,0,0,0
2022-02-03 07:30,129,53,76,0,0,0
2022-02-03 07:45,138,66,72,0,0,0
2022-02-03 08:00,119,60,59,0,0,0
2022-02-03 08:15,103,48,55,0,0,0
2022-02-03 08:30,136,64,72,0,0,0
2022-02-03 08:45,111,55,56,0,0,0
2022-02-03 09:00,75,29,46,0,0,0
2022-02-03 09:15,115,41,74,0,0,0
2022-02-03 09:30,91,30,61,0,0,0
2022-02-03 09:45,95,37,58,0,0,0
2022-02-03 10:00,81,31,50,0,0,0
2022-02-03 10:15,71,28,43,0,0,0
2022-02-03 10:30,57,20,37,0,0,0
2022-02-03 10:45,83,39,44,0,0,0
2022-02-03 11:00,73,26,47,0,0,0
2022-02-03 11:15,73,36,37,0,0,0
2022-02-03 11:30,100,41,59,0,0,0
2022-02-03 11:45,77,29,48,0,0,0
2022-02-03 12:00,96,36,60,0,0,0
2022-02-03 12:15,80,32,48,0,0,0
2022-02-03 12:30,104,41,63,0,0,0
2022-02-03 12:45,111,49,62,0,0,0
2022-02-03 13:00,134,55,79,0,0,0
2022-02-03 13:15,88,39,49,0,0,0
2022-02-03 13:30,86,33,53,0,0,0
2022-02-03 13:45,105,38,67,0,0,0
2022-02-03 14:00,109,51,58,0,0,0
2022-02-03 14:15,97,52,45,0,0,0
2022-02-03 14:30,109,51,58,0,0,0
2022-02-03 14:45,119,44,75,0,0,0
2022-02-03 15:00,107,51,56,0,0,0
2022-02-03 15:15,96,51,45,0,0,0
2022-02-03 15:30,78,31,47,0,0,0
2022-02-03 15:45,117,65,52,0,0,0
2022-02-03 16:00,117,49,68,0,0,0
2022-02-03 16:15,113,41,72,0,0,0
2022-02-03 16:30,127,69,58,0,0,0
2022-02-03 16:45,137,65,72,0,0,0
2022-02-03 17:00,130,56,74,0,0,0
2022-02-03 17:15,142,66,76,0,0,0
2022-02-03 17:30,136,65,71,0,0,0
2022-02-03 17:45,129,53,76,0,0,0
2022-02-03 18:00,140,71,69,0,0,0
2022-02-03 18:15,124,63,61,0,0,0
2022-02-03 18:30,120,55,65,0,0,0
2022-02-03 18:45,122,65,57,0,0,0
2022-02-03 19:00,94,47,47,0,0,0
2022-02-03 19:15,114,54,60,0,0,0
2022-02-03 19:30,87,42,45,0,0,0
2022-02-03 19:45,82,40,42,0,0,0
2022-02-03 20:00,79,36,43,0,0,0
2022-02-03 20:15,51,26,25,0,0,0
2022-02-03 20:30,61,33,28,0,0,0
2022-02-03 20:45,57,26,31,0,0,0
2022-02-03 21:00,50,20,30,0,0,0
2022-02-03 21:15,46,12,34,0,0,0
2022-02-03 21:30,35,12,23,0,0,0
2022-02-03 21:45,35,24,11,0,0,0
2022-02-03 22:00,35,19,16,0,0,0
2022-02-03 22:15,36,13,23,0,0,0
2022-02-03 22:30,45,6,39,0,0,0
2022-02-03 22:45,20,9,11,0,0,0
2022-02-03 23:00,25,5,20,0,0,0
2022-02-03 23:15,25,7,18,0,0,0
2022-02-03 23:30,17,8,9,0,0,0
2022-02-03 23:45,19,3,16,0,0,0
2022-02-04 00:00,14,2,12,0,0,0
2022-02-04 00:15,11,6,5,0,0,0
2022-02-04 00:30,5,2,3,0,0,0
2022-02-04 00:45,9,5,4,0,0,0
2022-02-04 01:00,5,4,1,0,0,0
2022-02-04 01:15,5,0,5,0,0,0
2022-02-04 01:30,5,3,2,0,0,0
2022-02-04 01:45,11,7,4,0,0,0
2022-02-04 02:00,0,0,0,0,0,0
2022-02-04 02:15,0,0,0,0,0,0
2022-02-04 02:30,4,2,2,0,0,0
2022-02-04 02:45,3,3,0,0,0,0
2022-02-04 03:00,0,0,0,0,0,0
2022-02-04 03:15,1,1,0,0,0,0
2022-02-04 03:30,0,0,0,0,0,0
2022-02-04 03:45,3,0,3,0,0,0
2022-02-04 04:00,0,0,0,0,0,0
2022-02-04 04:15,1,1,0,0,0,0
2022-02-04 04:30,1,0,1,0,0,0
2022-02-04 04:45,5,1,4,0,0,0
2022-02-04 05:00,2,1,1,0,0,0
2022-02-04 05:15,4,1,3,0,0,0
2022-02-04 05:30,14,8,6,0,0,0
2022-02-04 05:45,16,10,6,0,0,0
2022-02-04 06:00,20,7,13,0,0,0
2022-02-04 06:15,24,5,19,0,0,0
2022-02-04 06:30,34,9,25,0,0,0
2022-02-04 06:45,52,25,27,0,0,0
2022-02-04 07:00,64,31,33,0,0,0
2022-02-04 07:15,76,28,48,0,0,0
2022-02-04 07:30,137,63,74,0,0,0
2022-02-04 07:45,143,84,59,0,0,0
2022-02-04 08:00,108,48,60,0,0,0
2022-02-04 08:15,108,44,64,0,0,0
2022-02-04 08:30,89,46,43,0,0,0
2022-02-04 08:45,106,54,52,0,0,0
2022-02-04 09:00,81,36,45,0,0,0
2022-02-04 09:15,90,38,52,0,0,0
2022-02-04 09:30,82,30,52,0,0,0
2022-02-04 09:45,71,22,49,0,0,0
2022-02-04 10:00,90,39,51,0,0,0
2022-02-04 10:15,85,33,52,0,0,0
2022-02-04 10:30,74,26,48,0,0,0
2022-02-04 10:45,97,42,55,0,0,0
2022-02-04 11:00,82,24,58,0,0,0
2022-02-04 11:15,96,30,66,0,0,0
2022-02-04 11:30,77,30,47,0,0,0
2022-02-04 11:45,86,40,46,0,0,0
2022-02-04 12:00,95,35,60,0,0,0
2022-02-04 12:15,117,51,66,0,0,0
2022-02-04 12:30,116,54,62,0,0,0
2022-02-04 12:45,93,37,56,0,0,0
2022-02-04 13:00,129,54,75,0,0,0
2022-02-04 13:15,100,50,50,0,0,0
2022-02-04 13:30,127,55,72,0,0,0
2022-02-04 13:45,110,44,66,0,0,0
2022-02-04 14:00,109,50,59,0,0,0
2022-02-04 14:15,110,50,60,0,0,0
2022-02-04 14:30,92,47,45,0,0,0
2022-02-04 14:45,102,39,63,0,0,0
2022-02-04 15:00,87,32,55,0,0,0
2022-02-04 15:15,83,39,44,0,0,0
2022-02-04 15:30,89,33,56,0,0,0
2022-02-04 15:45,107,39,68,0,0,0
2022-02-04 16:00,103,48,55,0,0,0
2022-02-04 16:15,92,48,44,0,0,0
2022-02-04 16:30,90,41,49,0,0,0
2022-02-04 16:45,90,41,49,0,0,0
2022-02-04 17:00,80,27,53,0,0,0
2022-02-04 17:15,95,43,52,0,0,0
2022-02-04 17:30,78,37,41,0,0,0
2022-02-04 17:45,82,36,46,0,0,0
2022-02-04 18:00,84,25,59,0,0,0
2022-02-04 18:15,71,24,47,0,0,0
2022-02-04 18:30,68,27,41,0,0,0
2022-02-04 18:45,105,54,51,0,0,0
2022-02-04 19:00,84,36,48,0,0,0
2022-02-04 19:15,89,40,49,0,0,0
2022-02-04 19:30,69,39,30,0,0,0
2022-02-04 19:45,82,37,45,0,0,0
2022-02-04 20:00,89,45,44,0,0,0
2022-02-04 20:15,54,21,33,0,0,0
2022-02-04 20:30,49,20,29,0,0,0
2022-02-04 20:45,50,30,20,0,0,0
2022-02-04 21:00,37,14,23,0,0,0
2022-02-04 21:15,31,14,17,0,0,0
2022-02-04 21:30,35,13,22,0,0,0
2022-02-04 21:45,32,16,16,0,0,0
2022-02-04 22:00,31,14,17,0,0,0
2022-02-04 22:15,40,17,23,0,0,0
2022-02-04 22:30,66,21,45,0,0,0
2022-02-04 22:45,34,6,28,0,0,0
2022-02-04 23:00,37,12,25,0,0,0
2022-02-04 23:15,21,6,15,0,0,0
2022-02-04 23:30,30,16,14,0,0,0
2022-02-04 23:45,26,8,18,0,0,0
2022-02-05 00:00,28,9,19,0,0,0
2022-02-05 00:15,27,7,20,0,0,0
2022-02-05 00:30,21,11,10,0,0,0
2022-02-05 00:45,25,7,18,0,0,0
2022-02-05 01:00,25,6,19,0,0,0
2022-02-05 01:15,14,5,9,0,0,0
2022-02-05 01:30,11,5,6,0,0,0
2022-02-05 01:45,9,1,8,0,0,0
2022-02-05 02:00,12,3,9,0,0,0
2022-02-05 02:15,6,3,3,0,0,0
2022-02-05 02:30,9,3,6,0,0,0
2022-02-05 02:45,5,1,4,0,0,0
2022-02-05 03:00,19,3,16,0,0,0
2022-02-05 03:15,9,3,6,0,0,0
2022-02-05 03:30,3,1,2,0,0,0
2022-02-05 03:45,7,6,1,0,0,0
2022-02-05 04:00,2,0,2,0,0,0
2022-02-05 04:15,5,2,3,0,0,0
2022-02-05 04:30,6,2,4,0,0,0
2022-02-05 04:45,5,1,4,0,0,0
2022-02-05 05:00,6,0,6,0,0,0
2022-02-05 05:15,6,2,4,0,0,0
2022-02-05 05:30,10,2,8,0,0,0
2022-02-05 05:45,6,0,6,0,0,0
2022-02-05 06:00,4,2,2,0,0,0
2022-02-05 06:15,1,1,0,0,0,0
2022-02-05 06:30,5,2,3,0,0,0
2022-02-05 06:45,5,2,3,0,0,0
2022-02-05 07:00,10,6,4,0,0,0
2022-02-05 07:15,13,5,8,0,0,0
2022-02-05 07:30,13,4,9,0,0,0
2022-02-05 07:45,27,7,20,0,0,0
2022-02-05 08:00,13,3,10,0,0,0
2022-02-05 08:15,26,9,17,0,0,0
2022-02-05 08:30,30,10,20,0,0,0
2022-02-05 08:45,26,12,14,0,0,0
2022-02-05 09:00,34,9,25,0,0,0
2022-02-05 09:15,39,13,26,0,0,0
2022-02-05 09:30,53,20,33,0,0,0
2022-02-05 09:45,57,24,33,0,0,0
2022-02-05 10:00,52,23,29,0,0,0
2022-02-05 10:15,62,23,39,0,0,0
2022-02-05 10:30,53,21,32,0,0,0
2022-02-05 10:45,69,23,46,0,0,0
2022-02-05 11:00,74,27,47,0,0,0
2022-02-05 11:15,64,22,42,0,0,0
2022-02-05 11:30,92,32,60,0,0,0
2022-02-05 11:45,75,37,38,0,0,0
2022-02-05 12:00,94,42,52,0,0,0
2022-02-05 12:15,82,35,47,0,0,0
2022-02-05 12:30,83,42,41,0,0,0
2022-02-05 12:45,82,40,42,0,0,0
2022-02-05 13:00,81,35,46,0,0,0
2022-02-05 13:15,87,44,43,0,0,0
2022-02-05 13:30,60,31,29,0,0,0
2022-02-05 13:45,113,69,44,0,0,0
2022-02-05 14:00,119,52,67,0,0,0
2022-02-05 14:15,87,34,53,0,0,0
2022-02-05 14:30,101,47,54,0,0,0
2022-02-05 14:45,89,39,50,0,0,0
2022-02-05 15:00,91,35,56,0,0,0
2022-02-05 15:15,96,46,50,0,0,0
2022-02-05 15:30,93,37,56,0,0,0
2022-02-05 15:45,83,40,43,0,0,0
2022-02-05 16:00,75,29,46,0,0,0
2022-02-05 16:15,76,38,38,0,0,0
2022-02-05 16:30,92,44,48,0,0,0
2022-02-05 16:45,89,46,43,0,0,0
2022-02-05 17:00,69,37,32,0,0,0
2022-02-05 17:15,89,39,50,0,0,0
2022-02-05 17:30,74,34,40,0,0,0
2022-02-05 17:45,92,45,47,0,0,0
2022-02-05 18:00,86,51,35,0,0,0
2022-02-05 18:15,62,33,29,0,0,0
2022-02-05 18:30,68,25,43,0,0,0
2022-02-05 18:45,87,47,40,0,0,0
2022-02-05 19:00,66,32,34,0,0,0
2022-02-05 19:15,85,45,40,0,0,0
2022-02-05 19:30,58,35,23,0,0,0
2022-02-05 19:45,73,31,42,0,0,0
2022-02-05 20:00,70,33,37,0,0,0
2022-02-05 20:15,35,18,17,0,0,0
2022-02-05 20:30,47,19,28,0,0,0
2022-02-05 20:45,49,30,19,0,0,0
2022-02-05 21:00,34,12,22,0,0,0
2022-02-05 21:15,23,8,15,0,0,0
2022-02-05 21:30,36,20,16,0,0,0
2022-02-05 21:45,32,16,16,0,0,0
2022-02-05 22:00,42,13,29,0,0,0
2022-02-05 22:15,36,14,22,0,0,0
2022-02-05 22:30,50,15,35,0,0,0
2022-02-05 22:45,29,13,16,0,0,0
2022-02-05 23:00,26,8,18,0,0,0
2022-02-05 23:15,31,10,21,0,0,0
2022-02-05 23:30,32,12,20,0,0,0
2022-02-05 23:45,20,7,13,0,0,0
2022-02-06 00:00,19,7,12,0,0,0
2022-02-06 00:15,18,9,9,0,0,0
2022-02-06 00:30,33,10,23,0,0,0
2022-02-06 00:45,17,4,13,0,0,0
2022-02-06 01:00,29,11,18,0,0,0
2022-02-06 01:15,26,7,19,0,0,0
2022-02-06 01:30,8,3,5,0,0,0
2022-02-06 01:45,20,6,14,0,0,0
2022-02-06 02:00,16,5,11,0,0,0
2022-02-06 02:15,19,12,7,0,0,0
2022-02-06 02:30,3,3,0,0,0,0
2022-02-06 02:45,8,2,6,0,0,0
2022-02-06 03:00,7,4,3,0,0,0
2022-02-06 03:15,10,6,4,0,0,0
2022-02-06 03:30,9,3,6,0,0,0
2022-02-06 03:45,4,0,4,0,0,0
2022-02-06 04:00,5,2,3,0,0,0
2022-02-06 04:15,4,2,2,0,0,0
2022-02-06 04:30,5,4,1,0,0,0
2022-02-06 04:45,2,0,2,0,0,0
2022-02-06 05:00,1,0,1,0,0,0
2022-02-06 05:15,0,0,0,0,0,0
2022-02-06 05:30,10,1,9,0,0,0
2022-02-06 05:45,5,0,5,0,0,0
2022-02-06 06:00,5,2,3,0,0,0
2022-02-06 06:15,1,0,1,0,0,0
2022-02-06 06:30,2,1,1,0,0,0
2022-02-06 06:45,4,2,2,0,0,0
2022-02-06 07:00,3,1,2,0,0,0
2022-02-06 07:15,5,0,5,0,0,0
2022-02-06 07:30,9,3,6,0,0,0
2022-02-06 07:45,3,0,3,0,0,0
2022-02-06 08:00,7,1,6,0,0,0
2022-02-06 08:15,5,0,5,0,0,0
2022-02-06 08:30,8,2,6,0,0,0
2022-02-06 08:45,15,3,12,0,0,0
2022-02-06 09:00,21,6,15,0,0,0
2022-02-06 09:15,18,5,13,0,0,0
2022-02-06 09:30,15,8,7,0,0,0
2022-02-06 09:45,25,14,11,0,0,0
2022-02-06 10:00,18,7,11,0,0,0
2022-02-06 10:15,28,13,15,0,0,0
2022-02-06 10:30,18,8,10,0,0,0
2022-02-06 10:45,26,16,10,0,0,0
2022-02-06 11:00,14,8,6,0,0,0
2022-02-06 11:15,29,15,14,0,0,0
2022-02-06 11:30,38,10,28,0,0,0
2022-02-06 11:45,27,5,22,0,0,0
2022-02-06 12:00,26,10,16,0,0,0
2022-02-06 12:15,37,14,23,0,0,0
2022-02-06 12:30,46,16,30,0,0,0
2022-02-06 12:45,32,17,15,0,0,0
2022-02-06 13:00,37,8,29,0,0,0
2022-02-06 13:15,34,9,25,0,0,0
2022-02-06 13:30,36,10,26,0,0,0
2022-02-06 13:45,35,12,23,0,0,0
2022-02-06 14:00,46,14,32,0,0,0
2022-02-06 14:15,34,12,22,0,0,0
2022-02-06 14:30,48,16,32,0,0,0
2022-02-06 14:45,56,17,39,0,0,0
2022-02-06 15:00,34,10,24,0,0,0
2022-02-06 15:15,37,17,20,0,0,0
2022-02-06 15:30,31,14,17,0,0,0
2022-02-06 15:45,31,11,20,0,0,0
2022-02-06 16:00,40,18,22,0,0,0
2022-02-06 16:15,51,22,29,0,0,0
2022-02-06 16:30,41,14,27,0,0,0
2022-02-06 16:45,44,20,24,0,0,0
2022-02-06 17:00,32,13,19,0,0,0
2022-02-06 17:15,39,13,26,0,0,0
2022-02-06 17:30,41,9,32,0,0,0
2022-02-06 17:45,47,21,26,0,0,0
2022-02-06 18:00,53,15,38,0,0,0
2022-02-06 18:15,50,27,23,0,0,0
2022-02-06 18:30,21,8,13,0,0,0
2022-02-06 18:45,40,12,28,0,0,0
2022-02-06 19:00,36,12,24,0,0,0
2022-02-06 19:15,36,14,22,0,0,0
2022-02-06 19:30,54,20,34,0,0,0
2022-02-06 19:45,45,22,23,0,0,0
2022-02-06 20:00,33,11,22,0,0,0
2022-02-06 20:15,27,6,21,0,0,0
2022-02-06 20:30,24,9,15,0,0,0
2022-02-06 20:45,22,8,14,0,0,0
2022-02-06 21:00,19,6,13,0,0,0
2022-02-06 21:15,24,13,11,0,0,0
2022-02-06 21:30,20,8,12,0,0,0
2022-02-06 21:45,32,6,26,0,0,0
2022-02-06 22:00,20,12,8,0,0,0
2022-02-06 22:15,10,2,8,0,0,0
2022-02-06 22:30,9,2,7,0,0,0
2022-02-06 22:45,17,2,15,0,0,0
2022-02-06 23:00,5,0,5,0,0,0
2022-02-06 23:15,11,2,9,0,0,0
2022-02-06 23:30,6,2,4,0,0,0
2022-02-06 23:45,9,8,1,0,0,0
2022-02-07 00:00,7,2,5,0,0,0
2022-02-07 00:15,1,0,1,0,0,0
2022-02-07 00:30,0,0,0,0,0,0
2022-02-07 00:45,0,0,0,0,0,0
2022-02-07 01:00,2,1,1,0,0,0
2022-02-07 01:15,3,0,3,0,0,0
2022-02-07 01:30,2,2,0,0,0,0
2022-02-07 01:45,4,0,4,0,0,0
2022-02-07 02:00,0,0,0,0,0,0
2022-02-07 02:15,1,1,0,0,0,0
2022-02-07 02:30,0,0,0,0,0,0
2022-02-07 02:45,1,1,0,0,0,0
2022-02-07 03:00,0,0,0,0,0,0
2022-02-07 03:15,0,0,0,0,0,0
2022-02-07 03:30,1,1,0,0,0,0
2022-02-07 03:45,0,0,0,0,0,0
2022-02-07 04:00,1,0,1,0,0,0
2022-02-07 04:15,0,0,0,0,0,0
2022-02-07 04:30,2,0,2,0,0,0
2022-02-07 04:45,5,1,4,0,0,0
2022-02-07 05:00,1,1,0,0,0,0
2022-02-07 05:15,9,1,8,0,0,0
2022-02-07 05:30,15,8,7,0,0,0
2022-02-07 05:45,21,13,8,0,0,0
2022-02-07 06:00,20,7,13,0,0,0
2022-02-07 06:15,29,11,18,0,0,0
2022-02-07 06:30,33,17,16,0,0,0
2022-02-07 06:45,54,26,28,0,0,0
2022-02-07 07:00,66,33,33,0,0,0
2022-02-07 07:15,102,43,59,0,0,0
2022-02-07 07:30,117,51,66,0,0,0
2022-02-07 07:45,115,60,55,0,0,0
2022-02-07 08:00,119,67,52,0,0,0
2022-02-07 08:15,111,43,68,0,0,0
2022-02-07 08:30,113,39,74,0,0,0
2022-02-07 08:45,97,45,52,0,0,0
2022-02-07 09:00,94,38,56,0,0,0
2022-02-07 09:15,74,20,54,0,0,0
2022-02-07 09:30,77,29,48,0,0,0
2022-02-07 09:45,82,30,52,0,0,0
2022-02-07 10:00,94,38,56,0,0,0
2022-02-07 10:15,99,40,59,0,0,0
2022-02-07 10:30,65,29,36,0,0,0
2022-02-07 10:45,91,41,50,0,0,0
2022-02-07 11:00,77,29,48,0,0,0
2022-02-07 11:15,90,36,54,0,0,0
2022-02-07 11:30,82,32,50,0,0,0
2022-02-07 11:45,73,33,40,0,0,0
2022-02-07 12:00,89,51,38,0,0,0
2022-02-07 12:15,102,44,58,0,0,0
2022-02-07 12:30,102,48,54,0,0,0
2022-02-07 12:45,98,42,56,0,0,0
2022-02-07 13:00,84,40,44,0,0,0
2022-02-07 13:15,114,55,59,0,0,0
2022-02-07 13:30,96,47,49,0,0,0
2022-02-07 13:45,104,55,49,0,0,0
2022-02-07 14:00,94,48,46,0,0,0
2022-02-07 14:15,92,44,48,0,0,0
2022-02-07 14:30,103,59,44,0,0,0
2022-02-07 14:45,123,55,68,0,0,0
2022-02-07 15:00,85,45,40,0,0,0
2022-02-07 15:15,102,45,57,0,0,0
2022-02-07 15:30,117,56,61,0,0,0
2022-02-07 15:45,108,56,52,0,0,0
2022-02-07 16:00,124,58,66,0,0,0
2022-02-07 16:15,143,66,77,0,0,0
2022-02-07 16:30,121,50,71,0,0,0
2022-02-07 16:45,145,73,72,0,0,0
2022-02-07 17:00,189,96,93,0,0,0
2022-02-07 17:15,176,85,91,0,0,0
2022-02-07 17:30,129,65,64,0,0,0
2022-02-07 17:45,143,79,64,0,0,0
2022-02-07 18:00,151,83,68,0,0,0
2022-02-07 18:15,133,68,65,0,0,0
2022-02-07 18:30,93,41,52,0,0,0
2022-02-07 18:45,104,63,41,0,0,0
2022-02-07 19:00,96,45,51,0,0,0
2022-02-07 19:15,65,37,28,0,0,0
2022-02-07 19:30,64,42,22,0,0,0
2022-02-07 19:45,101,50,51,0,0,0
2022-02-07 20:00,84,41,43,0,0,0
2022-02-07 20:15,70,36,34,0,0,0
2022-02-07 20:30,47,20,27,0,0,0
2022-02-07 20:45,53,20,33,0,0,0
2022-02-07 21:00,41,20,21,0,0,0
2022-02-07 21:15,42,13,29,0,0,0
2022-02-07 21:30,44,22,22,0,0,0
2022-02-07 21:45,38,19,19,0,0,0
2022-02-07 22:00,34,6,28,0,0,0
2022-02-07 22:15,42,16,26,0,0,0
2022-02-07 22:30,17,4,13,0,0,0
2022-02-07 22:45,33,4,29,0,0,0
2022-02-07 23:00,31,11,20,0,0,0
2022-02-07 23:15,9,4,5,0,0,0
2022-02-07 23:30,11,5,6,0,0,0
2022-02-07 23:45,13,3,10,0,0,0
2022-02-08 00:00,10,3,7,0,0,0
2022-02-08 00:15,6,1,5,0,0,0
2022-02-08 00:30,1,1,0,0,0,0
2022-02-08 00:45,3,3,0,0,0,0
2022-02-08 01:00,5,1,4,0,0,0
2022-02-08 01:15,3,0,3,0,0,0
2022-02-08 01:30,2,1,1,0,0,0
2022-02-08 01:45,1,1,0,0,0,0
2022-02-08 02:00,0,0,0,0,0,0
2022-02-08 02:15,1,1,0,0,0,0
2022-02-08 02:30,1,1,0,0,0,0
2022-02-08 02:45,1,0,1,0,0,0
2022-02-08 03:00,1,0,1,0,0,0
2022-02-08 03:15,1,1,0,0,0,0
2022-02-08 03:30,4,2,2,0,0,0
2022-02-08 03:45,0,0,0,0,0,0
2022-02-08 04:00,3,0,3,0,0,0
2022-02-08 04:15,2,1,1,0,0,0
2022-02-08 04:30,3,0,3,0,0,0
2022-02-08 04:45,2,0,2,0,0,0
2022-02-08 05:00,3,0,3,0,0,0
2022-02-08 05:15,8,3,5,0,0,0
2022-02-08 05:30,21,11,10,0,0,0
2022-02-08 05:45,22,15,7,0,0,0
2022-02-08 06:00,20,5,15,0,0,0
2022-02-08 06:15,30,8,22,0,0,0
2022-02-08 06:30,38,16,22,0,0,0
2022-02-08 06:45,70,39,31,0,0,0
2022-02-08 07:00,66,26,40,0,0,0
2022-02-08 07:15,98,47,51,0,0,0
2022-02-08 07:30,132,48,84,0,0,0
2022-02-08 07:45,129,59,70,0,0,0
2022-02-08 08:00,121,52,69,0,0,0
2022-02-08 08:15,130,62,68,0,0,0
2022-02-08 08:30,124,56,68,0,0,0
2022-02-08 08:45,124,55,69,0,0,0
2022-02-08 09:00,101,50,51,0,0,0
2022-02-08 09:15,78,32,46,0,0,0
2022-02-08 09:30,94,35,59,0,0,0
2022-02-08 09:45,91,33,58,0,0,0
2022-02-08 10:00,81,29,52,0,0,0
2022-02-08 10:15,76,24,52,0,0,0
2022-02-08 10:30,56,27,29,0,0,0
2022-02-08 10:45,62,22,40,0,0,0
2022-02-08 11:00,74,32,42,0,0,0
2022-02-08 11:15,75,28,47,0,0,0
2022-02-08 11:30,93,46,47,0,0,0
2022-02-08 11:45,112,52,60,0,0,0
2022-02-08 12:00,112,50,62,0,0,0
2022-02-08 12:15,109,47,62,0,0,0
2022-02-08 12:30,110,41,69,0,0,0
2022-02-08 12:45,114,53,61,0,0,0
2022-02-08 13:00,122,51,71,0,0,0
2022-02-08 13:15,113,50,63,0,0,0
2022-02-08 13:30,120,62,58,0,0,0
2022-02-08 13:45,106,56,50,0,0,0
2022-02-08 14:00,114,52,62,0,0,0
2022-02-08 14:15,102,57,45,0,0,0
2022-02-08 14:30,87,45,42,0,0,0
2022-02-08 14:45,144,71,73,0,0,0
2022-02-08 15:00,107,55,52,0,0,0
2022-02-08 15:15,100,52,48,0,0,0
2022-02-08 15:30,101,53,48,0,0,0
2022-02-08 15:45,98,47,51,0,0,0
2022-02-08 16:00,123,56,67,0,0,0
2022-02-08 16:15,145,77,68,0,0,0
2022-02-08 16:30,150,78,72,0,0,0
2022-02-08 16:45,128,66,62,0,0,0
2022-02-08 17:00,142,70,72,0,0,0
2022-02-08 17:15,142,76,66,0,0,0
2022-02-08 17:30,120,52,68,0,0,0
2022-02-08 17:45,159,84,75,0,0,0
2022-02-08 18:00,119,45,74,0,0,0
2022-02-08 18:15,141,80,61,0,0,0
2022-02-08 18:30,122,60,62,0,0,0
2022-02-08 18:45,122,63,59,0,0,0
2022-02-08 19:00,117,54,63,0,0,0
2022-02-08 19:15,102,64,38,0,0,0
2022-02-08 19:30,88,40,48,0,0,0
2022-02-08 19:45,84,42,42,0,0,0
2022-02-08 20:00,75,27,48,0,0,0
2022-02-08 20:15,76,39,37,0,0,0
2022-02-08 20:30,50,19,31,0,0,0
2022-02-08 20:45,60,23,37,0,0,0
2022-02-08 21:00,44,15,29,0,0,0
2022-02-08 21:15,42,13,29,0,0,0
2022-02-08 21:30,34,15,19,0,0,0
2022-02-08 21:45,39,19,20,0,0,0
2022-02-08 22:00,41,10,31,0,0,0
2022-02-08 22:15,28,18,10,0,0,0
2022-02-08 22:30,48,12,36,0,0,0
2022-02-08 22:45,34,9,25,0,0,0
2022-02-08 23:00,23,8,15,0,0,0
2022-02-08 23:15,22,10,12,0,0,0
2022-02-08 23:30,11,6,5,0,0,0
2022-02-08 23:45,14,2,12,0,0,0
2022-02-09 00:00,9,4,5,0,0,0
2022-02-09 00:15,4,2,2,0,0,0
2022-02-09 00:30,8,1,7,0,0,0
2022-02-09 00:45,10,4,6,0,0,0
2022-02-09 01:00,4,2,2,0,0,0
2022-02-09 01:15,3,3,0,0,0,0
2022-02-09 01:30,5,0,5,0,0,0
2022-02-09 01:45,8,2,6,0,0,0
2022-02-09 02:00,1,0,1,0,0,0
2022-02-09 02:15,4,1,3,0,0,0
2022-02-09 02:30,3,0,3,0,0,0
2022-02-09 02:45,0,0,0,0,0,0
2022-02-09 03:00,1,0,1,0,0,0
2022-02-09 03:15,2,1,1,0,0,0
2022-02-09 03:30,0,0,0,0,0,0
2022-02-09 03:45,1,0,1,0,0,0
2022-02-09 04:00,0,0,0,0,0,0
2022-02-09 04:15,3,0,3,0,0,0
2022-02-09 04:30,4,2,2,0,0,0
2022-02-09 04:45,4,1,3,0,0,0
2022-02-09 05:00,3,2,1,0,0,0
2022-02-09 05:15,4,1,3,0,0,0
2022-02-09 05:30,19,9,10,0,0,0
2022-02-09 05:45,27,13,14,0,0,0
2022-02-09 06:00,26,8,18,0,0,0
2022-02-09 06:15,31,13,18,0,0,0
2022-02-09 06:30,42,15,27,0,0,0
2022-02-09 06:45,63,38,25,0,0,0
2022-02-09 07:00,67,33,34,0,0,0
2022-02-09 07:15,100,42,58,0,0,0
2022-02-09 07:30,102,44,58,0,0,0
2022-02-09 07:45,153,68,85,0,0,0
2022-02-09 08:00,117,59,58,0,0,0
2022-02-09 08:15,123,61,62,0,0,0
2022-02-09 08:30,122,70,52,0,0,0
2022-02-09 08:45,125,59,66,0,0,0
2022-02-09 09:00,104,44,60,0,0,0
2022-02-09 09:15,83,31,52,0,0,0
2022-02-09 09:30,65,32,33,0,0,0
2022-02-09 09:45,77,35,42,0,0,0
2022-02-09 10:00,79,32,47,0,0,0
2022-02-09 10:15,63,22,41,0,0,0
2022-02-09 10:30,68,22,46,0,0,0
2022-02-09 10:45,78,28,50,0,0,0
2022-02-09 11:00,86,43,43,0,0,0
2022-02-09 11:15,82,41,41,0,0,0
2022-02-09 11:30,89,49,40,0,0,0
2022-02-09 11:45,92,43,49,0,0,0
2022-02-09 12:00,89,33,56,0,0,0
2022-02-09 12:15,100,37,63,0,0,0
2022-02-09 12:30,115,59,56,0,0,0
2022-02-09 12:45,110,46,64,0,0,0
2022-02-09 13:00,105,47,58,0,0,0
2022-02-09 13:15,104,49,55,0,0,0
2022-02-09 13:30,95,52,43,0,0,0
2022-02-09 13:45,110,63,47,0,0,0
2022-02-09 14:00,104,61,43,0,0,0
2022-02-09 14:15,95,47,48,0,0,0
2022-02-09 14:30,101,47,54,0,0,0
2022-02-09 14:45,109,51,58,0,0,0
2022-02-09 15:00,108,57,51,0,0,0
2022-02-09 15:15,130,78,52,0,0,0
2022-02-09 15:30,143,85,58,0,0,0
2022-02-09 15:45,121,63,58,0,0,0
2022-02-09 16:00,155,79,76,0,0,0
2022-02-09 16:15,139,57,82,0,0,0
2022-02-09 16:30,113,54,59,0,0,0
2022-02-09 16:45,147,88,59,0,0,0
2022-02-09 17:00,153,80,73,0,0,0
2022-02-09 17:15,157,67,90,0,0,0
2022-02-09 17:30,118,64,54,0,0,0
2022-02-09 17:45,142,62,80,0,0,0
2022-02-09 18:00,118,47,71,0,0,0
2022-02-09 18:15,128,65,63,0,0,0
2022-02-09 18:30,135,72,63,0,0,0
2022-02-09 18:45,151,77,74,0,0,0
2022-02-09 19:00,101,54,47,0,0,0
2022-02-09 19:15,97,46,51,0,0,0
2022-02-09 19:30,65,35,30,0,0,0
2022-02-09 19:45,107,51,56,0,0,0
2022-02-09 20:00,95,45,50,0,0,0
2022-02-09 20:15,78,47,31,0,0,0
2022-02-09 20:30,40,18,22,0,0,0
2022-02-09 20:45,41,19,22,0,0,0
2022-02-09 21:00,51,25,26,0,0,0
2022-02-09 21:15,43,19,24,0,0,0
2022-02-09 21:30,59,24,35,0,0,0
2022-02-09 21:45,33,13,20,0,0,0
2022-02-09 22:00,43,16,27,0,0,0
2022-02-09 22:15,50,21,29,0,0,0
2022-02-09 22:30,47,14,33,0,0,0
2022-02-09 22:45,26,4,22,0,0,0
2022-02-09 23:00,38,10,28,0,0,0
2022-02-09 23:15,35,12,23,0,0,0
2022-02-09 23:30,24,5,19,0,0,0
2022-02-09 23:45,18,8,10,0,0,0
2022-02-10 00:00,26,8,18,0,0,0
2022-02-10 00:15,19,8,11,0,0,0
2022-02-10 00:30,6,1,5,0,0,0
2022-02-10 00:45,15,3,12,0,0,0
2022-02-10 01:00,13,10,3,0,0,0
2022-02-10 01:15,8,3,5,0,0,0
2022-02-10 01:30,2,0,2,0,0,0
2022-02-10 01:45,2,0,2,0,0,0
2022-02-10 02:00,3,3,0,0,0,0
2022-02-10 02:15,5,1,4,0,0,0
2022-02-10 02:30,2,1,1,0,0,0
2022-02-10 02:45,0,0,0,0,0,0
2022-02-10 03:00,0,0,0,0,0,0
2022-02-10 03:15,3,0,3,0,0,0
2022-02-10 03:30,1,1,0,0,0,0
2022-02-10 03:45,4,4,0,0,0,0
2022-02-10 04:00,2,1,1,0,0,0
2022-02-10 04:15,3,0,3,0,0,0
2022-02-10 04:30,4,2,2,0,0,0
2022-02-10 04:45,4,2,2,0,0,0
2022-02-10 05:00,9,1,8,0,0,0
2022-02-10 05:15,5,0,5,0,0,0
2022-02-10 05:30,13,8,5,0,0,0
2022-02-10 05:45,17,9,8,0,0,0
2022-02-10 06:00,16,6,10,0,0,0
2022-02-10 06:15,35,3,32,0,0,0
2022-02-10 06:30,37,11,26,0,0,0
2022-02-10 06:45,64,23,41,0,0,0
2022-02-10 07:00,72,32,40,0,0,0
2022-02-10 07:15,85,32,53,0,0,0
2022-02-10 07:30,134,48,86,0,0,0
2022-02-10 07:45,126,60,66,0,0,0
2022-02-10 08:00,131,68,63,0,0,0
2022-02-10 08:15,118,57,61,0,0,0
2022-02-10 08:30,121,63,58,0,0,0
2022-02-10 08:45,121,58,63,0,0,0
2022-02-10 09:00,78,37,41,0,0,0
2022-02-10 09:15,78,30,48,0,0,0
2022-02-10 09:30,90,42,48,0,0,0
2022-02-10 09:45,88,32,56,0,0,0
2022-02-10 10:00,79,27,52,0,0,0
2022-02-10 10:15,82,28,54,0,0,0
2022-02-10 10:30,52,15,37,0,0,0
2022-02-10 10:45,78,34,44,0,0,0
2022-02-10 11:00,58,22,36,0,0,0
2022-02-10 11:15,68,30,38,0,0,0
2022-02-10 11:30,86,32,54,0,0,0
2022-02-10 11:45,82,30,52,0,0,0
2022-02-10 12:00,90,36,54,0,0,0
2022-02-10 12:15,96,41,55,0,0,0
2022-02-10 12:30,93,28,65,0,0,0
2022-02-10 12:45,96,45,51,0,0,0
2022-02-10 13:00,111,46,65,0,0,0
2022-02-10 13:15,97,56,41,0,0,0
2022-02-10 13:30,98,49,49,0,0,0
2022-02-10 13:45,93,53,40,0,0,0
2022-02-10 14:00,129,79,50,0,0,0
2022-02-10 14:15,102,49,53,0,0,0
2022-02-10 14:30,101,41,60,0,0,0
2022-02-10 14:45,110,50,60,0,0,0
2022-02-10 15:00,102,49,53,0,0,0
2022-02-10 15:15,121,61,60,0,0,0
2022-02-10 15:30,109,45,64,0,0,0
2022-02-10 15:45,113,54,59,0,0,0
2022-02-10 16:00,140,72,68,0,0,0
2022-02-10 16:15,119,56,63,0,0,0
2022-02-10 16:30,119,48,71,0,0,0
2022-02-10 16:45,133,65,68,0,0,0
2022-02-10 17:00,127,54,73,0,0,0
2022-02-10 17:15,119,59,60,0,0,0
2022-02-10 17:30,124,54,70,0,0,0
2022-02-10 17:45,135,61,74,0,0,0
2022-02-10 18:00,128,62,66,0,0,0
2022-02-10 18:15,131,63,68,0,0,0
2022-02-10 18:30,120,64,56,0,0,0
2022-02-10 18:45,142,76,66,0,0,0
2022-02-10 19:00,113,55,58,0,0,0
2022-02-10 19:15,104,50,54,0,0,0
2022-02-10 19:30,85,38,47,0,0,0
2022-02-10 19:45,77,41,36,0,0,0
2022-02-10 20:00,70,30,40,0,0,0
2022-02-10 20:15,54,27,27,0,0,0
2022-02-10 20:30,55,25,30,0,0,0
2022-02-10 20:45,48,16,32,0,0,0
2022-02-10 21:00,41,16,25,0,0,0
2022-02-10 21:15,69,19,50,0,0,0
2022-02-10 21:30,41,17,24,0,0,0
2022-02-10 21:45,35,14,21,0,0,0
2022-02-10 22:00,34,11,23,0,0,0
2022-02-10 22:15,39,13,26,0,0,0
2022-02-10 22:30,37,8,29,0,0,0
2022-02-10 22:45,36,12,24,0,0,0
2022-02-10 23:00,34,5,29,0,0,0
2022-02-10 23:15,20,9,11,0,0,0
2022-02-10 23:30,34,11,23,0,0,0
2022-02-10 23:45,11,8,3,0,0,0
2022-02-11 00:00,19,5,14,0,0,0
2022-02-11 00:15,15,5,10,0,0,0
2022-02-11 00:30,15,6,9,0,0,0
2022-02-11 00:45,6,3,3,0,0,0
2022-02-11 01:00,10,5,5,0,0,0
2022-02-11 01:15,6,2,4,0,0,0
2022-02-11 01:30,6,3,3,0,0,0
2022-02-11 01:45,2,2,0,0,0,0
2022-02-11 02:00,0,0,0,0,0,0
2022-02-11 02:15,12,1,11,0,0,0
2022-02-11 02:30,3,2,1,0,0,0
2022-02-11 02:45,3,1,2,0,0,0
2022-02-11 03:00,0,0,0,0,0,0
2022-02-11 03:15,4,1,3,0,0,0
2022-02-11 03:30,2,1,1,0,0,0
2022-02-11 03:45,2,1,1,0,0,0
2022-02-11 04:00,1,1,0,0,0,0
2022-02-11 04:15,2,1,1,0,0,0
2022-02-11 04:30,0,0,0,0,0,0
2022-02-11 04:45,6,3,3,0,0,0
2022-02-11 05:00,2,1,1,0,0,0
2022-02-11 05:15,6,3,3,0,0,0
2022-02-11 05:30,13,8,5,0,0,0
2022-02-11 05:45,17,10,7,0,0,0
2022-02-11 06:00,17,7,10,0,0,0
2022-02-11 06:15,34,12,22,0,0,0
2022-02-11 06:30,48,13,35,0,0,0
2022-02-11 06:45,51,23,28,0,0,0
2022-02-11 07:00,64,33,31,0,0,0
2022-02-11 07:15,65,27,38,0,0,0
2022-02-11 07:30,122,51,71,0,0,0
2022-02-11 07:45,115,55,60,0,0,0
2022-02-11 08:00,93,51,42,0,0,0
2022-02-11 08:15,87,44,43,0,0,0
2022-02-11 08:30,112,54,58,0,0,0
2022-02-11 08:45,104,53,51,0,0,0
2022-02-11 09:00,72,27,45,0,0,0
2022-02-11 09:15,80,21,59,0,0,0
2022-02-11 09:30,87,38,49,0,0,0
2022-02-11 09:45,78,31,47,0,0,0
2022-02-11 10:00,78,32,46,0,0,0
2022-02-11 10:15,70,26,44,0,0,0
2022-02-11 10:30,77,32,45,0,0,0
2022-02-11 10:45,72,28,44,0,0,0
2022-02-11 11:00,64,24,40,0,0,0
2022-02-11 11:15,71,28,43,0,0,0
2022-02-11 11:30,87,39,48,0,0,0
2022-02-11 11:45,89,39,50,0,0,0
2022-02-11 12:00,84,35,49,0,0,0
2022-02-11 12:15,77,42,35,0,0,0
2022-02-11 12:30,96,40,56,0,0,0
2022-02-11 12:45,110,46,64,0,0,0
2022-02-11 13:00,86,47,39,0,0,0
2022-02-11 13:15,89,37,52,0,0,0
2022-02-11 13:30,77,24,53,0,0,0
2022-02-11 13:45,103,50,53,0,0,0
2022-02-11 14:00,89,38,51,0,0,0
2022-02-11 14:15,116,58,58,0,0,0
2022-02-11 14:30,99,32,67,0,0,0
2022-02-11 14:45,104,44,60,0,0,0
2022-02-11 15:00,97,45,52,0,0,0
2022-02-11 15:15,110,50,60,0,0,0
2022-02-11 15:30,87,30,57,0,0,0
2022-02-11 15:45,112,50,62,0,0,0
2022-02-11 16:00,123,63,60,0,0,0
2022-02-11 16:15,117,46,71,0,0,0
2022-02-11 16:30,102,50,52,0,0,0
2022-02-11 16:45,90,46,44,0,0,0
2022-02-11 17:00,87,47,40,0,0,0
2022-02-11 17:15,116,62,54,0,0,0
2022-02-11 17:30,101,48,53,0,0,0
2022-02-11 17:45,132,65,67,0,0,0
2022-02-11 18:00,108,47,61,0,0,0
2022-02-11 18:15,117,55,62,0,0,0
2022-02-11 18:30,93,45,48,0,0,0
2022-02-11 18:45,92,50,42,0,0,0
2022-02-11 19:00,114,61,53,0,0,0
2022-02-11 19:15,102,55,47,0,0,0
2022-02-11 19:30,73,39,34,0,0,0
2022-02-11 19:45,90,44,46,0,0,0
2022-02-11 20:00,84,39,45,0,0,0
2022-02-11 20:15,74,31,43,0,0,0
2022-02-11 20:30,65,39,26,0,0,0
2022-02-11 20:45,55,26,29,0,0,0
2022-02-11 21:00,56,23,33,0,0,0
2022-02-11 21:15,48,17,31,0,0,0
2022-02-11 21:30,50,20,30,0,0,0
2022-02-11 21:45,52,20,32,0,0,0
2022-02-11 22:00,44,11,33,0,0,0
2022-02-11 22:15,29,8,21,0,0,0
2022-02-11 22:30,42,15,27,0,0,0
2022-02-11 22:45,45,18,27,0,0,0
2022-02-11 23:00,36,15,21,0,0,0
2022-02-11 23:15,33,13,20,0,0,0
2022-02-11 23:30,27,9,18,0,0,0
2022-02-11 23:45,30,17,13,0,0,0
2022-02-12 00:00,34,15,19,0,0,0
2022-02-12 00:15,26,13,13,0,0,0
2022-02-12 00:30,18,6,12,0,0,0
2022-02-12 00:45,30,14,16,0,0,0
2022-02-12 01:00,25,11,14,0,0,0
2022-02-12 01:15,19,5,14,0,0,0
2022-02-12 01:30,9,3,6,0,0,0
2022-02-12 01:45,17,9,8,0,0,0
2022-02-12 02:00,12,6,6,0,0,0
2022-02-12 02:15,16,5,11,0,0,0
2022-02-12 02:30,13,4,9,0,0,0
2022-02-12 02:45,8,4,4,0,0,0
2022-02-12 03:00,3,3,0,0,0,0
2022-02-12 03:15,9,2,7,0,0,0
2022-02-12 03:30,4,1,3,0,0,0
2022-02-12 03:45,4,3,1,0,0,0
2022-02-12 04:00,6,4,2,0,0,0
2022-02-12 04:15,0,0,0,0,0,0
2022-02-12 04:30,5,2,3,0,0,0
2022-02-12 04:45,6,0,6,0,0,0
2022-02-12 05:00,1,1,0,0,0,0
2022-02-12 05:15,6,2,4,0,0,0
2022-02-12 05:30,12,1,11,0,0,0
2022-02-12 05:45,6,1,5,0,0,0
2022-02-12 06:00,3,1,2,0,0,0
2022-02-12 06:15,7,4,3,0,0,0
2022-02-12 06:30,7,5,2,0,0,0
2022-02-12 06:45,6,2,4,0,0,0
2022-02-12 07:00,9,2,7,0,0,0
2022-02-12 07:15,10,5,5,0,0,0
2022-02-12 07:30,13,5,8,0,0,0
2022-02-12 07:45,17,9,8,0,0,0
2022-02-12 08:00,16,7,9,0,0,0
2022-02-12 08:15,15,5,10,0,0,0
2022-02-12 08:30,34,10,24,0,0,0
2022-02-12 08:45,36,19,17,0,0,0
2022-02-12 09:00,39,16,23,0,0,0
2022-02-12 09:15,46,18,28,0,0,0
2022-02-12 09:30,44,20,24,0,0,0
2022-02-12 09:45,54,20,34,0,0,0
2022-02-12 10:00,48,24,24,0,0,0
2022-02-12 10:15,54,19,35,0,0,0
2022-02-12 10:30,71,29,42,0,0,0
2022-02-12 10:45,67,26,41,0,0,0
2022-02-12 11:00,67,32,35,0,0,0
2022-02-12 11:15,63,32,31,0,0,0
2022-02-12 11:30,78,30,48,0,0,0
2022-02-12 11:45,84,44,40,0,0,0
2022-02-12 12:00,79,38,41,0,0,0
2022-02-12 12:15,94,37,57,0,0,0
2022-02-12 12:30,80,30,50,0,0,0
2022-02-12 12:45,109,44,65,0,0,0
2022-02-12 13:00,83,41,42,0,0,0
2022-02-12 13:15,101,49,52,0,0,0
2022-02-12 13:30,90,33,57,0,0,0
2022-02-12 13:45,97,54,43,0,0,0
2022-02-12 14:00,110,44,66,0,0,0
2022-02-12 14:15,99,42,57,0,0,0
2022-02-12 14:30,69,37,32,0,0,0
2022-02-12 14:45,96,41,55,0,0,0
2022-02-12 15:00,103,52,51,0,0,0
2022-02-12 15:15,108,49,59,0,0,0
2022-02-12 15:30,83,44,39,0,0,0
2022-02-12 15:45,84,39,45,0,0,0
2022-02-12 16:00,78,25,53,0,0,0
2022-02-12 16:15,80,43,37,0,0,0
2022-02-12 16:30,95,42,53,0,0,0
2022-02-12 16:45,116,58,58,0,0,0
2022-02-12 17:00,95,38,57,0,0,0
2022-02-12 17:15,82,35,47,0,0,0
2022-02-12 17:30,74,29,45,0,0,0
2022-02-12 17:45,86,54,32,0,0,0
2022-02-12 18:00,95,42,53,0,0,0
2022-02-12 18:15,77,39,38,0,0,0
2022-02-12 18:30,78,41,37,0,0,0
2022-02-12 18:45,82,41,41,0,0,0
2022-02-12 19:00,87,43,44,0,0,0
2022-02-12 19:15,81,44,37,0,0,0
2022-02-12 19:30,77,42,35,0,0,0
2022-02-12 19:45,81,43,38,0,0,0
2022-02-12 20:00,78,36,42,0,0,0
2022-02-12 20:15,53,18,35,0,0,0
2022-02-12 20:30,51,27,24,0,0,0
2022-02-12 20:45,63,30,33,0,0,0
2022-02-12 21:00,42,20,22,0,0,0
2022-02-12 21:15,26,12,14,0,0,0
2022-02-12 21:30,27,15,12,0,0,0
2022-02-12 21:45,35,19,16,0,0,0
2022-02-12 22:00,48,18,30,0,0,0
2022-02-12 22:15,45,13,32,0,0,0
2022-02-12 22:30,43,10,33,0,0,0
2022-02-12 22:45,50,20,30,0,0,0
2022-02-12 23:00,28,18,10,0,0,0
2022-02-12 23:15,20,7,13,0,0,0
2022-02-12 23:30,22,5,17,0,0,0
2022-02-12 23:45,30,13,17,0,0,0
2022-02-13 00:00,35,14,21,0,0,0
2022-02-13 00:15,31,17,14,0,0,0
2022-02-13 00:30,18,6,12,0,0,0
2022-02-13 00:45,22,5,17,0,0,0
2022-02-13 01:00,33,13,20,0,0,0
2022-02-13 01:15,21,5,16,0,0,0
2022-02-13 01:30,23,9,14,0,0,0
2022-02-13 01:45,18,3,15,0,0,0
2022-02-13 02:00,19,9,10,0,0,0
2022-02-13 02:15,18,8,10,0,0,0
2022-02-13 02:30,10,4,6,0,0,0
2022-02-13 02:45,14,3,11,0,0,0
2022-02-13 03:00,3,2,1,0,0,0
2022-02-13 03:15,11,5,6,0,0,0
2022-02-13 03:30,8,0,8,0,0,0
2022-02-13 03:45,4,3,1,0,0,0
2022-02-13 04:00,7,3,4,0,0,0
2022-02-13 04:15,8,1,7,0,0,0
2022-02-13 04:30,8,1,7,0,0,0
2022-02-13 04:45,8,2,6,0,0,0
2022-02-13 05:00,4,0,4,0,0,0
2022-02-13 05:15,1,0,1,0,0,0
2022-02-13 05:30,5,2,3,0,0,0
2022-02-13 05:45,2,0,2,0,0,0
2022-02-13 06:00,1,1,0,0,0,0
2022-02-13 06:15,7,3,4,0,0,0
2022-02-13 06:30,5,4,1,0,0,0
2022-02-13 06:45,2,1,1,0,0,0
2022-02-13 07:00,3,1,2,0,0,0
2022-02-13 07:15,4,1,3,0,0,0
2022-02-13 07:30,8,1,7,0,0,0
2022-02-13 07:45,10,3,7,0,0,0
2022-02-13 08:00,5,1,4,0,0,0
2022-02-13 08:15,9,1,8,0,0,0
2022-02-13 08:30,18,10,8,0,0,0
2022-02-13 08:45,26,12,14,0,0,0
2022-02-13 09:00,15,4,11,0,0,0
2022-02-13 09:15,24,5,19,0,0,0
2022-02-13 09:30,30,11,19,0,0,0
2022-02-13 09:45,37,13,24,0,0,0
2022-02-13 10:00,26,11,15,0,0,0
2022-02-13 10:15,22,10,12,0,0,0
2022-02-13 10:30,32,15,17,0,0,0
2022-02-13 10:45,30,21,9,0,0,0
2022-02-13 11:00,25,13,12,0,0,0
2022-02-13 11:15,39,19,20,0,0,0
2022-02-13 11:30,40,20,20,0,0,0
2022-02-13 11:45,54,20,34,0,0,0
2022-02-13 12:00,53,32,21,0,0,0
2022-02-13 12:15,63,25,38,0,0,0
2022-02-13 12:30,50,18,32,0,0,0
2022-02-13 12:45,71,33,38,0,0,0
2022-02-13 13:00,62,31,31,0,0,0
2022-02-13 13:15,61,20,41,0,0,0
2022-02-13 13:30,68,21,47,0,0,0
2022-02-13 13:45,75,31,44,0,0,0
2022-02-13 14:00,79,32,47,0,0,0
2022-02-13 14:15,86,36,50,0,0,0
2022-02-13 14:30,74,23,51,0,0,0
2022-02-13 14:45,81,33,48,0,0,0
2022-02-13 15:00,71,29,42,0,0,0
2022-02-13 15:15,84,36,48,0,0,0
2022-02-13 15:30,71,31,40,0,0,0
2022-02-13 15:45,89,51,38,0,0,0
2022-02-13 16:00,66,20,46,0,0,0
2022-02-13 16:15,66,29,37,0,0,0
2022-02-13 16:30,82,48,34,0,0,0
2022-02-13 16:45,88,32,56,0,0,0
2022-02-13 17:00,59,29,30,0,0,0
2022-02-13 17:15,74,28,46,0,0,0
2022-02-13 17:30,82,37,45,0,0,0
2022-02-13 17:45,67,31,36,0,0,0
2022-02-13 18:00,83,29,54,0,0,0
2022-02-13 18:15,60,24,36,0,0,0
2022-02-13 18:30,56,25,31,0,0,0
2022-02-13 18:45,42,15,27,0,0,0
2022-02-13 19:00,84,38,46,0,0,0
2022-02-13 19:15,51,28,23,0,0,0
2022-02-13 19:30,55,26,29,0,0,0
2022-02-13 19:45,56,23,33,0,0,0
2022-02-13 20:00,59,18,41,0,0,0
2022-02-13 20:15,48,16,32,0,0,0
2022-02-13 20:30,44,14,30,0,0,0
2022-02-13 20:45,42,19,23,0,0,0
2022-02-13 21:00,20,10,10,0,0,0
2022-02-13 21:15,26,5,21,0,0,0
2022-02-13 21:30,31,9,22,0,0,0
2022-02-13 21:45,12,7,5,0,0,0
2022-02-13 22:00,50,9,41,0,0,0
2022-02-13 22:15,24,5,19,0,0,0
2022-02-13 22:30,25,15,10,0,0,0
2022-02-13 22:45,19,3,16,0,0,0
2022-02-13 23:00,17,7,10,0,0,0
2022-02-13 23:15,25,5,20,0,0,0
2022-02-13 23:30,15,2,13,0,0,0
2022-02-13 23:45,8,4,4,0,0,0
2022-02-14 00:00,8,2,6,0,0,0
2022-02-14 00:15,4,4,0,0,0,0
2022-02-14 00:30,1,1,0,0,0,0
2022-02-14 00:45,1,1,0,0,0,0
2022-02-14 01:00,0,0,0,0,0,0
2022-02-14 01:15,3,2,1,0,0,0
2022-02-14 01:30,3,1,2,0,0,0
2022-02-14 01:45,8,1,7,0,0,0
2022-02-14 02:00,5,0,5,0,0,0
2022-02-14 02:15,1,1,0,0,0,0
2022-02-14 02:30,3,1,2,0,0,0
2022-02-14 02:45,2,1,1,0,0,0
2022-02-14 03:00,0,0,0,0,0,0
2022-02-14 03:15,0,0,0,0,0,0
2022-02-14 03:30,1,1,0,0,0,0
2022-02-14 03:45,2,2,0,0,0,0
2022-02-14 04:00,11,4,7,0,0,0
2022-02-14 04:15,15,10,5,0,0,0
2022-02-14 04:30,10,3,7,0,0,0
2022-02-14 04:45,5,2,3,0,0,0
2022-02-14 05:00,0,0,0,0,0,0
2022-02-14 05:15,4,2,2,0,0,0
2022-02-14 05:30,14,8,6,0,0,0
2022-02-14 05:45,23,13,10,0,0,0
2022-02-14 06:00,18,4,14,0,0,0
2022-02-14 06:15,30,15,15,0,0,0
2022-02-14 06:30,45,22,23,0,0,0
2022-02-14 06:45,55,23,32,0,0,0
2022-02-14 07:00,87,39,48,0,0,0
2022-02-14 07:15,92,41,51,0,0,0
2022-02-14 07:30,143,61,82,0,0,0
2022-02-14 07:45,129,61,68,0,0,0
2022-02-14 08:00,115,68,47,0,0,0
2022-02-14 08:15,107,57,50,0,0,0
2022-02-14 08:30,101,49,52,0,0,0
2022-02-14 08:45,107,54,53,0,0,0
2022-02-14 09:00,80,30,50,0,0,0
2022-02-14 09:15,80,31,49,0,0,0
2022-02-14 09:30,55,8,47,0,0,0
2022-02-14 09:45,67,6,61,0,0,0
2022-02-14 10:00,80,33,47,0,0,0
2022-02-14 10:15,68,33,35,0,0,0
2022-02-14 10:30,70,29,41,0,0,0
2022-02-14 10:45,78,35,43,0,0,0
2022-02-14 11:00,81,27,54,0,0,0
2022-02-14 11:15,62,27,35,0,0,0
2022-02-14 11:30,93,52,41,0,0,0
2022-02-14 11:45,102,41,61,0,0,0
2022-02-14 12:00,97,43,54,0,0,0
2022-02-14 12:15,92,46,46,0,0,0
2022-02-14 12:30,102,47,55,0,0,0
2022-02-14 12:45,95,42,53,0,0,0
2022-02-14 13:00,95,53,42,0,0,0
2022-02-14 13:15,98,50,48,0,0,0
2022-02-14 13:30,86,42,44,0,0,0
2022-02-14 13:45,106,60,46,0,0,0
2022-02-14 14:00,108,44,64,0,0,0
2022-02-14 14:15,79,32,47,0,0,0
2022-02-14 14:30,99,51,48,0,0,0
2022-02-14 14:45,137,72,65,0,0,0
2022-02-14 15:00,97,36,61,0,0,0
2022-02-14 15:15,97,52,45,0,0,0
2022-02-14 15:30,101,54,47,0,0,0
2022-02-14 15:45,127,69,58,0,0,0
2022-02-14 16:00,106,51,55,0,0,0
2022-02-14 16:15,126,61,65,0,0,0
2022-02-14 16:30,122,65,57,0,0,0
2022-02-14 16:45,150,72,78,0,0,0
2022-02-14 17:00,153,66,87,0,0,0
2022-02-14 17:15,157,69,88,0,0,0
2022-02-14 17:30,133,60,73,0,0,0
2022-02-14 17:45,158,75,83,0,0,0
2022-02-14 18:00,153,75,78,0,0,0
2022-02-14 18:15,117,57,60,0,0,0
2022-02-14 18:30,103,43,60,0,0,0
2022-02-14 18:45,115,64,51,0,0,0
2022-02-14 19:00,97,44,53,0,0,0
2022-02-14 19:15,96,42,54,0,0,0
2022-02-14 19:30,112,45,67,0,0,0
2022-02-14 19:45,114,53,61,0,0,0
2022-02-14 20:00,93,40,53,0,0,0
2022-02-14 20:15,71,29,42,0,0,0
2022-02-14 20:30,53,33,20,0,0,0
2022-02-14 20:45,50,20,30,0,0,0
2022-02-14 21:00,43,16,27,0,0,0
2022-02-14 21:15,54,23,31,0,0,0
2022-02-14 21:30,37,17,20,0,0,0
2022-02-14 21:45,43,17,26,0,0,0
2022-02-14 22:00,36,13,23,0,0,0
2022-02-14 22:15,47,13,34,0,0,0
2022-02-14 22:30,34,14,20,0,0,0
2022-02-14 22:45,42,11,31,0,0,0
2022-02-14 23:00,22,5,17,0,0,0
2022-02-14 23:15,20,11,9,0,0,0
2022-02-14 23:30,9,2,7,0,0,0
2022-02-14 23:45,14,4,10,0,0,0
