Datetime,100034978 (Gartenstraße),101034978 (Gartenstraße einwärts),102034978 (Gartenstraße auswärts),100034978-status,101034978-status,102034978-status
2022-03-01 00:00,4,0,4,0,0,0
2022-03-01 00:15,1,0,1,0,0,0
2022-03-01 00:30,3,0,3,0,0,0
2022-03-01 00:45,2,1,1,0,0,0
2022-03-01 01:00,1,1,0,0,0,0
2022-03-01 01:15,0,0,0,0,0,0
2022-03-01 01:30,3,0,3,0,0,0
2022-03-01 01:45,1,1,0,0,0,0
2022-03-01 02:00,2,1,1,0,0,0
2022-03-01 02:15,2,0,2,0,0,0
2022-03-01 02:30,1,0,1,0,0,0
2022-03-01 02:45,2,0,2,0,0,0
2022-03-01 03:00,1,0,1,0,0,0
2022-03-01 03:15,0,0,0,0,0,0
2022-03-01 03:30,0,0,0,0,0,0
2022-03-01 03:45,2,1,1,0,0,0
2022-03-01 04:00,0,0,0,0,0,0
2022-03-01 04:15,0,0,0,0,0,0
2022-03-01 04:30,3,3,0,0,0,0
2022-03-01 04:45,2,1,1,0,0,0
2022-03-01 05:00,1,1,0,0,0,0
2022-03-01 05:15,3,1,2,0,0,0
2022-03-01 05:30,7,6,1,0,0,0
2022-03-01 05:45,13,7,6,0,0,0
2022-03-01 06:00,10,4,6,0,0,0
2022-03-01 06:15,14,9,5,0,0,0
2022-03-01 06:30,44,21,23,0,0,0
2022-03-01 06:45,34,15,19,0,0,0
2022-03-01 07:00,26,14,12,0,0,0
2022-03-01 07:15,42,26,16,0,0,0
2022-03-01 07:30,79,47,32,0,0,0
2022-03-01 07:45,74,43,31,0,0,0
2022-03-01 08:00,56,37,19,0,0,0
2022-03-01 08:15,62,42,20,0,0,0
2022-03-01 08:30,48,39,9,0,0,0
2022-03-01 08:45,41,28,13,0,0,0
2022-03-01 09:00,30,22,8,0,0,0
2022-03-01 09:15,29,21,8,0,0,0
2022-03-01 09:30,32,24,8,0,0,0
2022-03-01 09:45,31,21,10,0,0,0
2022-03-01 10:00,41,27,14,0,0,0
2022-03-01 10:15,35,27,8,0,0,0
2022-03-01 10:30,29,17,12,0,0,0
2022-03-01 10:45,30,22,8,0,0,0
2022-03-01 11:00,34,12,22,0,0,0
2022-03-01 11:15,32,19,13,0,0,0
2022-03-01 11:30,36,22,14,0,0,0
2022-03-01 11:45,44,28,16,0,0,0
2022-03-01 12:00,29,18,11,0,0,0
2022-03-01 12:15,38,20,18,0,0,0
2022-03-01 12:30,36,16,20,0,0,0
2022-03-01 12:45,33,20,13,0,0,0
2022-03-01 13:00,38,19,19,0,0,0
2022-03-01 13:15,53,32,21,0,0,0
2022-03-01 13:30,38,26,12,0,0,0
2022-03-01 13:45,49,31,18,0,0,0
2022-03-01 14:00,53,30,23,0,0,0
2022-03-01 14:15,50,31,19,0,0,0
2022-03-01 14:30,51,30,21,0,0,0
2022-03-01 14:45,66,37,29,0,0,0
2022-03-01 15:00,52,31,21,0,0,0
2022-03-01 15:15,73,50,23,0,0,0
2022-03-01 15:30,64,35,29,0,0,0
2022-03-01 15:45,75,40,35,0,0,0
2022-03-01 16:00,63,38,25,0,0,0
2022-03-01 16:15,57,29,28,0,0,0
2022-03-01 16:30,62,34,28,0,0,0
2022-03-01 16:45,72,42,30,0,0,0
2022-03-01 17:00,73,34,39,0,0,0
2022-03-01 17:15,56,21,35,0,0,0
2022-03-01 17:30,60,30,30,0,0,0
2022-03-01 17:45,62,27,35,0,0,0
2022-03-01 18:00,62,26,36,0,0,0
2022-03-01 18:15,37,15,22,0,0,0
2022-03-01 18:30,48,20,28,0,0,0
2022-03-01 18:45,32,17,15,0,0,0
2022-03-01 19:00,27,11,16,0,0,0
2022-03-01 19:15,33,15,18,0,0,0
2022-03-01 19:30,27,13,14,0,0,0
2022-03-01 19:45,26,16,10,0,0,0
2022-03-01 20:00,23,9,14,0,0,0
2022-03-01 20:15,32,19,13,0,0,0
2022-03-01 20:30,15,6,9,0,0,0
2022-03-01 20:45,15,7,8,0,0,0
2022-03-01 21:00,12,6,6,0,0,0
2022-03-01 21:15,13,2,11,0,0,0
2022-03-01 21:30,12,4,8,0,0,0
2022-03-01 21:45,14,6,8,0,0,0
2022-03-01 22:00,14,0,14,0,0,0
2022-03-01 22:15,3,2,1,0,0,0
2022-03-01 22:30,15,1,14,0,0,0
2022-03-01 22:45,8,3,5,0,0,0
2022-03-01 23:00,4,1,3,0,0,0
2022-03-01 23:15,10,3,7,0,0,0
2022-03-01 23:30,2,0,2,0,0,0
2022-03-01 23:45,3,2,1,0,0,0
2022-03-02 00:00,4,1,3,0,0,0
2022-03-02 00:15,0,0,0,0,0,0
2022-03-02 00:30,0,0,0,0,0,0
2022-03-02 00:45,4,1,3,0,0,0
2022-03-02 01:00,0,0,0,0,0,0
2022-03-02 01:15,3,1,2,0,0,0
2022-03-02 01:30,0,0,0,0,0,0
2022-03-02 01:45,1,0,1,0,0,0
2022-03-02 02:00,2,0,2,0,0,0
2022-03-02 02:15,1,0,1,0,0,0
2022-03-02 02:30,3,2,1,0,0,0
2022-03-02 02:45,0,0,0,0,0,0
2022-03-02 03:00,0,0,0,0,0,0
2022-03-02 03:15,0,0,0,0,0,0
2022-03-02 03:30,0,0,0,0,0,0
2022-03-02 03:45,2,1,1,0,0,0
2022-03-02 04:00,0,0,0,0,0,0
2022-03-02 04:15,2,2,0,0,0,0
2022-03-02 04:30,4,4,0,0,0,0
2022-03-02 04:45,0,0,0,0,0,0
2022-03-02 05:00,1,1,0,0,0,0
2022-03-02 05:15,4,3,1,0,0,0
2022-03-02 05:30,9,5,4,0,0,0
2022-03-02 05:45,14,8,6,0,0,0
2022-03-02 06:00,11,3,8,0,0,0
2022-03-02 06:15,27,11,16,0,0,0
2022-03-02 06:30,32,17,15,0,0,0
2022-03-02 06:45,22,10,12,0,0,0
2022-03-02 07:00,38,23,15,0,0,0
2022-03-02 07:15,78,60,18,0,0,0
2022-03-02 07:30,118,90,28,0,0,0
2022-03-02 07:45,102,70,32,0,0,0
2022-03-02 08:00,64,43,21,0,0,0
2022-03-02 08:15,66,44,22,0,0,0
2022-03-02 08:30,54,32,22,0,0,0
2022-03-02 08:45,40,27,13,0,0,0
2022-03-02 09:00,36,22,14,0,0,0
2022-03-02 09:15,36,24,12,0,0,0
2022-03-02 09:30,37,26,11,0,0,0
2022-03-02 09:45,47,36,11,0,0,0
2022-03-02 10:00,35,26,9,0,0,0
2022-03-02 10:15,42,30,12,0,0,0
2022-03-02 10:30,31,20,11,0,0,0
2022-03-02 10:45,35,22,13,0,0,0
2022-03-02 11:00,31,17,14,0,0,0
2022-03-02 11:15,33,18,15,0,0,0
2022-03-02 11:30,35,17,18,0,0,0
2022-03-02 11:45,39,17,22,0,0,0
2022-03-02 12:00,29,17,12,0,0,0
2022-03-02 12:15,45,24,21,0,0,0
2022-03-02 12:30,50,30,20,0,0,0
2022-03-02 12:45,31,16,15,0,0,0
2022-03-02 13:00,53,23,30,0,0,0
2022-03-02 13:15,63,27,36,0,0,0
2022-03-02 13:30,47,30,17,0,0,0
2022-03-02 13:45,45,21,24,0,0,0
2022-03-02 14:00,49,19,30,0,0,0
2022-03-02 14:15,38,23,15,0,0,0
2022-03-02 14:30,48,18,30,0,0,0
2022-03-02 14:45,49,24,25,0,0,0
2022-03-02 15:00,61,35,26,0,0,0
2022-03-02 15:15,68,44,24,0,0,0
2022-03-02 15:30,61,26,35,0,0,0
2022-03-02 15:45,74,34,40,0,0,0
2022-03-02 16:00,70,40,30,0,0,0
2022-03-02 16:15,93,56,37,0,0,0
2022-03-02 16:30,65,31,34,0,0,0
2022-03-02 16:45,81,50,31,0,0,0
2022-03-02 17:00,77,41,36,0,0,0
2022-03-02 17:15,67,36,31,0,0,0
2022-03-02 17:30,70,30,40,0,0,0
2022-03-02 17:45,59,30,29,0,0,0
2022-03-02 18:00,51,28,23,0,0,0
2022-03-02 18:15,46,21,25,0,0,0
2022-03-02 18:30,49,19,30,0,0,0
2022-03-02 18:45,63,30,33,0,0,0
2022-03-02 19:00,28,11,17,0,0,0
2022-03-02 19:15,39,19,20,0,0,0
2022-03-02 19:30,37,18,19,0,0,0
2022-03-02 19:45,30,18,12,0,0,0
2022-03-02 20:00,27,14,13,0,0,0
2022-03-02 20:15,23,6,17,0,0,0
2022-03-02 20:30,17,7,10,0,0,0
2022-03-02 20:45,16,8,8,0,0,0
2022-03-02 21:00,23,13,10,0,0,0
2022-03-02 21:15,16,5,11,0,0,0
2022-03-02 21:30,10,3,7,0,0,0
2022-03-02 21:45,7,3,4,0,0,0
2022-03-02 22:00,12,2,10,0,0,0
2022-03-02 22:15,10,5,5,0,0,0
2022-03-02 22:30,8,1,7,0,0,0
2022-03-02 22:45,7,2,5,0,0,0
2022-03-02 23:00,9,3,6,0,0,0
2022-03-02 23:15,6,2,4,0,0,0
2022-03-02 23:30,4,1,3,0,0,0
2022-03-02 23:45,2,0,2,0,0,0
2022-03-03 00:00,8,3,5,0,0,0
2022-03-03 00:15,3,0,3,0,0,0
2022-03-03 00:30,2,0,2,0,0,0
2022-03-03 00:45,1,0,1,0,0,0
2022-03-03 01:00,0,0,0,0,0,0
2022-03-03 01:15,1,0,1,0,0,0
2022-03-03 01:30,4,1,3,0,0,0
2022-03-03 01:45,2,0,2,0,0,0
2022-03-03 02:00,0,0,0,0,0,0
2022-03-03 02:15,2,1,1,0,0,0
2022-03-03 02:30,0,0,0,0,0,0
2022-03-03 02:45,0,0,0,0,0,0
2022-03-03 03:00,0,0,0,0,0,0
2022-03-03 03:15,1,1,0,0,0,0
2022-03-03 03:30,0,0,0,0,0,0
2022-03-03 03:45,1,1,0,0,0,0
2022-03-03 04:00,1,1,0,0,0,0
2022-03-03 04:15,2,1,1,0,0,0
2022-03-03 04:30,2,1,1,0,0,0
2022-03-03 04:45,2,1,1,0,0,0
2022-03-03 05:00,2,2,0,0,0,0
2022-03-03 05:15,4,2,2,0,0,0
2022-03-03 05:30,9,5,4,0,0,0
2022-03-03 05:45,18,12,6,0,0,0
2022-03-03 06:00,6,1,5,0,0,0
2022-03-03 06:15,23,10,13,0,0,0
2022-03-03 06:30,31,13,18,0,0,0
2022-03-03 06:45,39,16,23,0,0,0
2022-03-03 07:00,27,16,11,0,0,0
2022-03-03 07:15,89,72,17,0,0,0
2022-03-03 07:30,171,151,20,0,0,0
2022-03-03 07:45,83,55,28,0,0,0
2022-03-03 08:00,65,42,23,0,0,0
2022-03-03 08:15,66,41,25,0,0,0
2022-03-03 08:30,49,32,17,0,0,0
2022-03-03 08:45,43,26,17,0,0,0
2022-03-03 09:00,17,10,7,0,0,0
2022-03-03 09:15,26,20,6,0,0,0
2022-03-03 09:30,35,20,15,0,0,0
2022-03-03 09:45,36,22,14,0,0,0
2022-03-03 10:00,23,13,10,0,0,0
2022-03-03 10:15,21,15,6,0,0,0
2022-03-03 10:30,27,18,9,0,0,0
2022-03-03 10:45,33,14,19,0,0,0
2022-03-03 11:00,23,14,9,0,0,0
2022-03-03 11:15,39,26,13,0,0,0
2022-03-03 11:30,29,16,13,0,0,0
2022-03-03 11:45,47,27,20,0,0,0
2022-03-03 12:00,26,10,16,0,0,0
2022-03-03 12:15,46,26,20,0,0,0
2022-03-03 12:30,42,14,28,0,0,0
2022-03-03 12:45,45,24,21,0,0,0
2022-03-03 13:00,47,15,32,0,0,0
2022-03-03 13:15,67,31,36,0,0,0
2022-03-03 13:30,50,28,22,0,0,0
2022-03-03 13:45,56,28,28,0,0,0
2022-03-03 14:00,46,18,28,0,0,0
2022-03-03 14:15,47,28,19,0,0,0
2022-03-03 14:30,52,31,21,0,0,0
2022-03-03 14:45,64,29,35,0,0,0
2022-03-03 15:00,75,39,36,0,0,0
2022-03-03 15:15,66,42,24,0,0,0
2022-03-03 15:30,59,33,26,0,0,0
2022-03-03 15:45,95,59,36,0,0,0
2022-03-03 16:00,84,54,30,0,0,0
2022-03-03 16:15,58,30,28,0,0,0
2022-03-03 16:30,72,42,30,0,0,0
2022-03-03 16:45,77,46,31,0,0,0
2022-03-03 17:00,64,43,21,0,0,0
2022-03-03 17:15,74,37,37,0,0,0
2022-03-03 17:30,59,34,25,0,0,0
2022-03-03 17:45,67,30,37,0,0,0
2022-03-03 18:00,65,34,31,0,0,0
2022-03-03 18:15,50,22,28,0,0,0
2022-03-03 18:30,43,22,21,0,0,0
2022-03-03 18:45,45,29,16,0,0,0
2022-03-03 19:00,41,19,22,0,0,0
2022-03-03 19:15,25,9,16,0,0,0
2022-03-03 19:30,28,17,11,0,0,0
2022-03-03 19:45,34,9,25,0,0,0
2022-03-03 20:00,18,7,11,0,0,0
2022-03-03 20:15,19,10,9,0,0,0
2022-03-03 20:30,8,5,3,0,0,0
2022-03-03 20:45,18,11,7,0,0,0
2022-03-03 21:00,12,7,5,0,0,0
2022-03-03 21:15,11,2,9,0,0,0
2022-03-03 21:30,19,5,14,0,0,0
2022-03-03 21:45,14,1,13,0,0,0
2022-03-03 22:00,13,3,10,0,0,0
2022-03-03 22:15,19,6,13,0,0,0
2022-03-03 22:30,10,1,9,0,0,0
2022-03-03 22:45,9,5,4,0,0,0
2022-03-03 23:00,3,2,1,0,0,0
2022-03-03 23:15,2,1,1,0,0,0
2022-03-03 23:30,4,2,2,0,0,0
2022-03-03 23:45,5,3,2,0,0,0
2022-03-04 00:00,2,1,1,0,0,0
2022-03-04 00:15,3,0,3,0,0,0
2022-03-04 00:30,2,1,1,0,0,0
2022-03-04 00:45,5,1,4,0,0,0
2022-03-04 01:00,2,1,1,0,0,0
2022-03-04 01:15,1,0,1,0,0,0
2022-03-04 01:30,1,0,1,0,0,0
2022-03-04 01:45,2,1,1,0,0,0
2022-03-04 02:00,0,0,0,0,0,0
2022-03-04 02:15,1,0,1,0,0,0
2022-03-04 02:30,0,0,0,0,0,0
2022-03-04 02:45,0,0,0,0,0,0
2022-03-04 03:00,0,0,0,0,0,0
2022-03-04 03:15,0,0,0,0,0,0
2022-03-04 03:30,0,0,0,0,0,0
2022-03-04 03:45,1,1,0,0,0,0
2022-03-04 04:00,0,0,0,0,0,0
2022-03-04 04:15,1,1,0,0,0,0
2022-03-04 04:30,1,1,0,0,0,0
2022-03-04 04:45,3,2,1,0,0,0
2022-03-04 05:00,3,2,1,0,0,0
2022-03-04 05:15,4,3,1,0,0,0
2022-03-04 05:30,8,5,3,0,0,0
2022-03-04 05:45,19,8,11,0,0,0
2022-03-04 06:00,7,3,4,0,0,0
2022-03-04 06:15,14,6,8,0,0,0
2022-03-04 06:30,24,11,13,0,0,0
2022-03-04 06:45,28,16,12,0,0,0
2022-03-04 07:00,36,21,15,0,0,0
2022-03-04 07:15,76,62,14,0,0,0
2022-03-04 07:30,136,109,27,0,0,0
2022-03-04 07:45,85,61,24,0,0,0
2022-03-04 08:00,56,35,21,0,0,0
2022-03-04 08:15,51,38,13,0,0,0
2022-03-04 08:30,53,32,21,0,0,0
2022-03-04 08:45,47,34,13,0,0,0
2022-03-04 09:00,32,19,13,0,0,0
2022-03-04 09:15,20,14,6,0,0,0
2022-03-04 09:30,35,24,11,0,0,0
2022-03-04 09:45,36,27,9,0,0,0
2022-03-04 10:00,32,19,13,0,0,0
2022-03-04 10:15,42,28,14,0,0,0
2022-03-04 10:30,36,22,14,0,0,0
2022-03-04 10:45,32,27,5,0,0,0
2022-03-04 11:00,43,28,15,0,0,0
2022-03-04 11:15,32,23,9,0,0,0
2022-03-04 11:30,27,18,9,0,0,0
2022-03-04 11:45,41,26,15,0,0,0
2022-03-04 12:00,38,21,17,0,0,0
2022-03-04 12:15,44,24,20,0,0,0
2022-03-04 12:30,60,25,35,0,0,0
2022-03-04 12:45,55,33,22,0,0,0
2022-03-04 13:00,77,31,46,0,0,0
2022-03-04 13:15,72,27,45,0,0,0
2022-03-04 13:30,59,26,33,0,0,0
2022-03-04 13:45,45,27,18,0,0,0
2022-03-04 14:00,66,40,26,0,0,0
2022-03-04 14:15,56,28,28,0,0,0
2022-03-04 14:30,46,25,21,0,0,0
2022-03-04 14:45,72,34,38,0,0,0
2022-03-04 15:00,67,37,30,0,0,0
2022-03-04 15:15,66,34,32,0,0,0
2022-03-04 15:30,73,38,35,0,0,0
2022-03-04 15:45,64,44,20,0,0,0
2022-03-04 16:00,53,28,25,0,0,0
2022-03-04 16:15,57,33,24,0,0,0
2022-03-04 16:30,61,32,29,0,0,0
2022-03-04 16:45,45,25,20,0,0,0
2022-03-04 17:00,41,21,20,0,0,0
2022-03-04 17:15,49,29,20,0,0,0
2022-03-04 17:30,45,20,25,0,0,0
2022-03-04 17:45,39,18,21,0,0,0
2022-03-04 18:00,54,21,33,0,0,0
2022-03-04 18:15,48,23,25,0,0,0
2022-03-04 18:30,59,26,33,0,0,0
2022-03-04 18:45,48,23,25,0,0,0
2022-03-04 19:00,32,13,19,0,0,0
2022-03-04 19:15,25,18,7,0,0,0
2022-03-04 19:30,41,20,21,0,0,0
2022-03-04 19:45,23,16,7,0,0,0
2022-03-04 20:00,27,13,14,0,0,0
2022-03-04 20:15,23,8,15,0,0,0
2022-03-04 20:30,18,8,10,0,0,0
2022-03-04 20:45,15,7,8,0,0,0
2022-03-04 21:00,23,5,18,0,0,0
2022-03-04 21:15,23,8,15,0,0,0
2022-03-04 21:30,6,2,4,0,0,0
2022-03-04 21:45,17,9,8,0,0,0
2022-03-04 22:00,13,5,8,0,0,0
2022-03-04 22:15,11,3,8,0,0,0
2022-03-04 22:30,6,1,5,0,0,0
2022-03-04 22:45,14,3,11,0,0,0
2022-03-04 23:00,11,2,9,0,0,0
2022-03-04 23:15,10,3,7,0,0,0
2022-03-04 23:30,1,1,0,0,0,0
2022-03-04 23:45,8,4,4,0,0,0
2022-03-05 00:00,3,1,2,0,0,0
2022-03-05 00:15,7,1,6,0,0,0
2022-03-05 00:30,6,2,4,0,0,0
2022-03-05 00:45,4,4,0,0,0,0
2022-03-05 01:00,2,2,0,0,0,0
2022-03-05 01:15,7,1,6,0,0,0
2022-03-05 01:30,9,1,8,0,0,0
2022-03-05 01:45,4,0,4,0,0,0
2022-03-05 02:00,3,0,3,0,0,0
2022-03-05 02:15,5,0,5,0,0,0
2022-03-05 02:30,1,0,1,0,0,0
2022-03-05 02:45,6,3,3,0,0,0
2022-03-05 03:00,1,1,0,0,0,0
2022-03-05 03:15,2,0,2,0,0,0
2022-03-05 03:30,4,3,1,0,0,0
2022-03-05 03:45,1,0,1,0,0,0
2022-03-05 04:00,1,0,1,0,0,0
2022-03-05 04:15,0,0,0,0,0,0
2022-03-05 04:30,2,1,1,0,0,0
2022-03-05 04:45,2,1,1,0,0,0
2022-03-05 05:00,1,1,0,0,0,0
2022-03-05 05:15,3,3,0,0,0,0
2022-03-05 05:30,2,1,1,0,0,0
2022-03-05 05:45,1,1,0,0,0,0
2022-03-05 06:00,4,4,0,0,0,0
2022-03-05 06:15,2,1,1,0,0,0
2022-03-05 06:30,4,2,2,0,0,0
2022-03-05 06:45,2,2,0,0,0,0
2022-03-05 07:00,8,4,4,0,0,0
2022-03-05 07:15,7,5,2,0,0,0
2022-03-05 07:30,8,6,2,0,0,0
2022-03-05 07:45,11,7,4,0,0,0
2022-03-05 08:00,12,9,3,0,0,0
2022-03-05 08:15,12,9,3,0,0,0
2022-03-05 08:30,17,15,2,0,0,0
2022-03-05 08:45,22,15,7,0,0,0
2022-03-05 09:00,20,12,8,0,0,0
2022-03-05 09:15,28,18,10,0,0,0
2022-03-05 09:30,25,21,4,0,0,0
2022-03-05 09:45,59,48,11,0,0,0
2022-03-05 10:00,27,19,8,0,0,0
2022-03-05 10:15,27,20,7,0,0,0
2022-03-05 10:30,42,29,13,0,0,0
2022-03-05 10:45,53,39,14,0,0,0
2022-03-05 11:00,48,31,17,0,0,0
2022-03-05 11:15,46,26,20,0,0,0
2022-03-05 11:30,46,23,23,0,0,0
2022-03-05 11:45,58,32,26,0,0,0
2022-03-05 12:00,56,38,18,0,0,0
2022-03-05 12:15,43,26,17,0,0,0
2022-03-05 12:30,34,18,16,0,0,0
2022-03-05 12:45,54,26,28,0,0,0
2022-03-05 13:00,40,18,22,0,0,0
2022-03-05 13:15,36,29,7,0,0,0
2022-03-05 13:30,42,17,25,0,0,0
2022-03-05 13:45,38,18,20,0,0,0
2022-03-05 14:00,37,20,17,0,0,0
2022-03-05 14:15,51,25,26,0,0,0
2022-03-05 14:30,51,31,20,0,0,0
2022-03-05 14:45,57,37,20,0,0,0
2022-03-05 15:00,36,21,15,0,0,0
2022-03-05 15:15,49,28,21,0,0,0
2022-03-05 15:30,57,24,33,0,0,0
2022-03-05 15:45,47,24,23,0,0,0
2022-03-05 16:00,42,26,16,0,0,0
2022-03-05 16:15,25,14,11,0,0,0
2022-03-05 16:30,39,20,19,0,0,0
2022-03-05 16:45,31,15,16,0,0,0
2022-03-05 17:00,38,25,13,0,0,0
2022-03-05 17:15,35,17,18,0,0,0
2022-03-05 17:30,27,13,14,0,0,0
2022-03-05 17:45,29,16,13,0,0,0
2022-03-05 18:00,49,22,27,0,0,0
2022-03-05 18:15,44,20,24,0,0,0
2022-03-05 18:30,43,34,9,0,0,0
2022-03-05 18:45,35,19,16,0,0,0
2022-03-05 19:00,37,22,15,0,0,0
2022-03-05 19:15,24,16,8,0,0,0
2022-03-05 19:30,14,9,5,0,0,0
2022-03-05 19:45,27,8,19,0,0,0
2022-03-05 20:00,16,10,6,0,0,0
2022-03-05 20:15,14,4,10,0,0,0
2022-03-05 20:30,18,13,5,0,0,0
2022-03-05 20:45,15,10,5,0,0,0
2022-03-05 21:00,6,2,4,0,0,0
2022-03-05 21:15,19,12,7,0,0,0
2022-03-05 21:30,17,13,4,0,0,0
2022-03-05 21:45,22,8,14,0,0,0
2022-03-05 22:00,15,3,12,0,0,0
2022-03-05 22:15,8,3,5,0,0,0
2022-03-05 22:30,19,11,8,0,0,0
2022-03-05 22:45,13,0,13,0,0,0
2022-03-05 23:00,5,0,5,0,0,0
2022-03-05 23:15,13,3,10,0,0,0
2022-03-05 23:30,15,8,7,0,0,0
2022-03-05 23:45,6,2,4,0,0,0
2022-03-06 00:00,11,4,7,0,0,0
2022-03-06 00:15,4,0,4,0,0,0
2022-03-06 00:30,7,3,4,0,0,0
2022-03-06 00:45,5,2,3,0,0,0
2022-03-06 01:00,3,2,1,0,0,0
2022-03-06 01:15,2,1,1,0,0,0
2022-03-06 01:30,2,0,2,0,0,0
2022-03-06 01:45,2,0,2,0,0,0
2022-03-06 02:00,6,2,4,0,0,0
2022-03-06 02:15,1,0,1,0,0,0
2022-03-06 02:30,1,0,1,0,0,0
2022-03-06 02:45,1,0,1,0,0,0
2022-03-06 03:00,1,0,1,0,0,0
2022-03-06 03:15,3,0,3,0,0,0
2022-03-06 03:30,1,1,0,0,0,0
2022-03-06 03:45,4,0,4,0,0,0
2022-03-06 04:00,1,0,1,0,0,0
2022-03-06 04:15,0,0,0,0,0,0
2022-03-06 04:30,3,0,3,0,0,0
2022-03-06 04:45,0,0,0,0,0,0
2022-03-06 05:00,1,0,1,0,0,0
2022-03-06 05:15,0,0,0,0,0,0
2022-03-06 05:30,1,1,0,0,0,0
2022-03-06 05:45,2,1,1,0,0,0
2022-03-06 06:00,2,2,0,0,0,0
2022-03-06 06:15,3,2,1,0,0,0
2022-03-06 06:30,2,2,0,0,0,0
2022-03-06 06:45,2,1,1,0,0,0
2022-03-06 07:00,0,0,0,0,0,0
2022-03-06 07:15,4,4,0,0,0,0
2022-03-06 07:30,2,2,0,0,0,0
2022-03-06 07:45,3,1,2,0,0,0
2022-03-06 08:00,1,1,0,0,0,0
2022-03-06 08:15,5,3,2,0,0,0
2022-03-06 08:30,4,2,2,0,0,0
2022-03-06 08:45,6,4,2,0,0,0
2022-03-06 09:00,11,8,3,0,0,0
2022-03-06 09:15,7,5,2,0,0,0
2022-03-06 09:30,5,4,1,0,0,0
2022-03-06 09:45,20,14,6,0,0,0
2022-03-06 10:00,10,8,2,0,0,0
2022-03-06 10:15,16,8,8,0,0,0
2022-03-06 10:30,13,6,7,0,0,0
2022-03-06 10:45,14,9,5,0,0,0
2022-03-06 11:00,18,7,11,0,0,0
2022-03-06 11:15,27,21,6,0,0,0
2022-03-06 11:30,18,9,9,0,0,0
2022-03-06 11:45,23,15,8,0,0,0
2022-03-06 12:00,27,22,5,0,0,0
2022-03-06 12:15,39,13,26,0,0,0
2022-03-06 12:30,28,13,15,0,0,0
2022-03-06 12:45,33,21,12,0,0,0
2022-03-06 13:00,24,15,9,0,0,0
2022-03-06 13:15,24,17,7,0,0,0
2022-03-06 13:30,27,21,6,0,0,0
2022-03-06 13:45,29,18,11,0,0,0
2022-03-06 14:00,22,12,10,0,0,0
2022-03-06 14:15,32,17,15,0,0,0
2022-03-06 14:30,28,12,16,0,0,0
2022-03-06 14:45,35,17,18,0,0,0
2022-03-06 15:00,28,17,11,0,0,0
2022-03-06 15:15,38,23,15,0,0,0
2022-03-06 15:30,27,11,16,0,0,0
2022-03-06 15:45,24,13,11,0,0,0
2022-03-06 16:00,38,24,14,0,0,0
2022-03-06 16:15,23,12,11,0,0,0
2022-03-06 16:30,34,19,15,0,0,0
2022-03-06 16:45,21,13,8,0,0,0
2022-03-06 17:00,24,14,10,0,0,0
2022-03-06 17:15,21,15,6,0,0,0
2022-03-06 17:30,31,22,9,0,0,0
2022-03-06 17:45,31,18,13,0,0,0
2022-03-06 18:00,20,9,11,0,0,0
2022-03-06 18:15,21,16,5,0,0,0
2022-03-06 18:30,18,12,6,0,0,0
2022-03-06 18:45,10,4,6,0,0,0
2022-03-06 19:00,13,7,6,0,0,0
2022-03-06 19:15,25,12,13,0,0,0
2022-03-06 19:30,11,6,5,0,0,0
2022-03-06 19:45,12,8,4,0,0,0
2022-03-06 20:00,4,0,4,0,0,0
2022-03-06 20:15,11,3,8,0,0,0
2022-03-06 20:30,12,2,10,0,0,0
2022-03-06 20:45,7,1,6,0,0,0
2022-03-06 21:00,6,1,5,0,0,0
2022-03-06 21:15,13,2,11,0,0,0
2022-03-06 21:30,8,3,5,0,0,0
2022-03-06 21:45,5,1,4,0,0,0
2022-03-06 22:00,6,2,4,0,0,0
2022-03-06 22:15,10,3,7,0,0,0
2022-03-06 22:30,6,1,5,0,0,0
2022-03-06 22:45,1,0,1,0,0,0
2022-03-06 23:00,5,1,4,0,0,0
2022-03-06 23:15,4,1,3,0,0,0
2022-03-06 23:30,3,0,3,0,0,0
2022-03-06 23:45,0,0,0,0,0,0
2022-03-07 00:00,1,0,1,0,0,0
2022-03-07 00:15,1,0,1,0,0,0
2022-03-07 00:30,0,0,0,0,0,0
2022-03-07 00:45,0,0,0,0,0,0
2022-03-07 01:00,1,0,1,0,0,0
2022-03-07 01:15,1,0,1,0,0,0
2022-03-07 01:30,3,2,1,0,0,0
2022-03-07 01:45,0,0,0,0,0,0
2022-03-07 02:00,1,0,1,0,0,0
2022-03-07 02:15,1,0,1,0,0,0
2022-03-07 02:30,0,0,0,0,0,0
2022-03-07 02:45,0,0,0,0,0,0
2022-03-07 03:00,0,0,0,0,0,0
2022-03-07 03:15,0,0,0,0,0,0
2022-03-07 03:30,2,1,1,0,0,0
2022-03-07 03:45,1,1,0,0,0,0
2022-03-07 04:00,1,0,1,0,0,0
2022-03-07 04:15,1,1,0,0,0,0
2022-03-07 04:30,1,1,0,0,0,0
2022-03-07 04:45,2,2,0,0,0,0
2022-03-07 05:00,3,1,2,0,0,0
2022-03-07 05:15,3,2,1,0,0,0
2022-03-07 05:30,12,7,5,0,0,0
2022-03-07 05:45,13,8,5,0,0,0
2022-03-07 06:00,11,5,6,0,0,0
2022-03-07 06:15,16,7,9,0,0,0
2022-03-07 06:30,33,20,13,0,0,0
2022-03-07 06:45,29,18,11,0,0,0
2022-03-07 07:00,34,21,13,0,0,0
2022-03-07 07:15,79,66,13,0,0,0
2022-03-07 07:30,145,115,30,0,0,0
2022-03-07 07:45,95,65,30,0,0,0
2022-03-07 08:00,58,40,18,0,0,0
2022-03-07 08:15,55,37,18,0,0,0
2022-03-07 08:30,47,33,14,0,0,0
2022-03-07 08:45,42,32,10,0,0,0
2022-03-07 09:00,32,20,12,0,0,0
2022-03-07 09:15,16,12,4,0,0,0
2022-03-07 09:30,25,19,6,0,0,0
2022-03-07 09:45,36,24,12,0,0,0
2022-03-07 10:00,27,20,7,0,0,0
2022-03-07 10:15,33,18,15,0,0,0
2022-03-07 10:30,32,21,11,0,0,0
2022-03-07 10:45,41,30,11,0,0,0
2022-03-07 11:00,37,23,14,0,0,0
2022-03-07 11:15,36,23,13,0,0,0
2022-03-07 11:30,38,23,15,0,0,0
2022-03-07 11:45,47,33,14,0,0,0
2022-03-07 12:00,27,15,12,0,0,0
2022-03-07 12:15,39,22,17,0,0,0
2022-03-07 12:30,42,22,20,0,0,0
2022-03-07 12:45,54,28,26,0,0,0
2022-03-07 13:00,47,17,30,0,0,0
2022-03-07 13:15,50,18,32,0,0,0
2022-03-07 13:30,43,19,24,0,0,0
2022-03-07 13:45,51,23,28,0,0,0
2022-03-07 14:00,58,26,32,0,0,0
2022-03-07 14:15,53,33,20,0,0,0
2022-03-07 14:30,68,37,31,0,0,0
2022-03-07 14:45,59,38,21,0,0,0
2022-03-07 15:00,61,33,28,0,0,0
2022-03-07 15:15,61,36,25,0,0,0
2022-03-07 15:30,80,38,42,0,0,0
2022-03-07 15:45,46,20,26,0,0,0
2022-03-07 16:00,87,47,40,0,0,0
2022-03-07 16:15,78,47,31,0,0,0
2022-03-07 16:30,65,37,28,0,0,0
2022-03-07 16:45,83,44,39,0,0,0
2022-03-07 17:00,70,45,25,0,0,0
2022-03-07 17:15,65,30,35,0,0,0
2022-03-07 17:30,68,42,26,0,0,0
2022-03-07 17:45,68,40,28,0,0,0
2022-03-07 18:00,61,31,30,0,0,0
2022-03-07 18:15,51,23,28,0,0,0
2022-03-07 18:30,43,20,23,0,0,0
2022-03-07 18:45,36,21,15,0,0,0
2022-03-07 19:00,46,23,23,0,0,0
2022-03-07 19:15,27,6,21,0,0,0
2022-03-07 19:30,27,17,10,0,0,0
2022-03-07 19:45,42,19,23,0,0,0
2022-03-07 20:00,26,10,16,0,0,0
2022-03-07 20:15,21,9,12,0,0,0
2022-03-07 20:30,13,4,9,0,0,0
2022-03-07 20:45,10,5,5,0,0,0
2022-03-07 21:00,13,5,8,0,0,0
2022-03-07 21:15,12,5,7,0,0,0
2022-03-07 21:30,16,4,12,0,0,0
2022-03-07 21:45,15,7,8,0,0,0
2022-03-07 22:00,11,2,9,0,0,0
2022-03-07 22:15,13,5,8,0,0,0
2022-03-07 22:30,7,2,5,0,0,0
2022-03-07 22:45,7,1,6,0,0,0
2022-03-07 23:00,4,0,4,0,0,0
2022-03-07 23:15,5,3,2,0,0,0
2022-03-07 23:30,6,5,1,0,0,0
2022-03-07 23:45,2,2,0,0,0,0
2022-03-08 00:00,1,1,0,0,0,0
2022-03-08 00:15,2,0,2,0,0,0
2022-03-08 00:30,0,0,0,0,0,0
2022-03-08 00:45,0,0,0,0,0,0
2022-03-08 01:00,0,0,0,0,0,0
2022-03-08 01:15,2,0,2,0,0,0
2022-03-08 01:30,1,0,1,0,0,0
2022-03-08 01:45,1,1,0,0,0,0
2022-03-08 02:00,0,0,0,0,0,0
2022-03-08 02:15,2,0,2,0,0,0
2022-03-08 02:30,1,0,1,0,0,0
2022-03-08 02:45,0,0,0,0,0,0
2022-03-08 03:00,1,1,0,0,0,0
2022-03-08 03:15,1,0,1,0,0,0
2022-03-08 03:30,0,0,0,0,0,0
2022-03-08 03:45,1,1,0,0,0,0
2022-03-08 04:00,1,0,1,0,0,0
2022-03-08 04:15,2,2,0,0,0,0
2022-03-08 04:30,0,0,0,0,0,0
2022-03-08 04:45,2,1,1,0,0,0
2022-03-08 05:00,1,1,0,0,0,0
2022-03-08 05:15,2,1,1,0,0,0
2022-03-08 05:30,8,5,3,0,0,0
2022-03-08 05:45,14,9,5,0,0,0
2022-03-08 06:00,8,2,6,0,0,0
2022-03-08 06:15,22,12,10,0,0,0
2022-03-08 06:30,35,19,16,0,0,0
2022-03-08 06:45,45,20,25,0,0,0
2022-03-08 07:00,30,21,9,0,0,0
2022-03-08 07:15,76,57,19,0,0,0
2022-03-08 07:30,155,128,27,0,0,0
2022-03-08 07:45,88,59,29,0,0,0
2022-03-08 08:00,74,49,25,0,0,0
2022-03-08 08:15,66,42,24,0,0,0
2022-03-08 08:30,50,34,16,0,0,0
2022-03-08 08:45,49,29,20,0,0,0
2022-03-08 09:00,31,18,13,0,0,0
2022-03-08 09:15,28,19,9,0,0,0
2022-03-08 09:30,44,32,12,0,0,0
2022-03-08 09:45,35,19,16,0,0,0
2022-03-08 10:00,36,18,18,0,0,0
2022-03-08 10:15,39,28,11,0,0,0
2022-03-08 10:30,29,19,10,0,0,0
2022-03-08 10:45,33,27,6,0,0,0
2022-03-08 11:00,30,17,13,0,0,0
2022-03-08 11:15,36,19,17,0,0,0
2022-03-08 11:30,27,20,7,0,0,0
2022-03-08 11:45,37,25,12,0,0,0
2022-03-08 12:00,32,18,14,0,0,0
2022-03-08 12:15,35,19,16,0,0,0
2022-03-08 12:30,43,16,27,0,0,0
2022-03-08 12:45,43,27,16,0,0,0
2022-03-08 13:00,60,28,32,0,0,0
2022-03-08 13:15,69,23,46,0,0,0
2022-03-08 13:30,49,24,25,0,0,0
2022-03-08 13:45,59,37,22,0,0,0
2022-03-08 14:00,55,29,26,0,0,0
2022-03-08 14:15,51,29,22,0,0,0
2022-03-08 14:30,53,27,26,0,0,0
2022-03-08 14:45,53,37,16,0,0,0
2022-03-08 15:00,53,34,19,0,0,0
2022-03-08 15:15,75,47,28,0,0,0
2022-03-08 15:30,62,32,30,0,0,0
2022-03-08 15:45,79,34,45,0,0,0
2022-03-08 16:00,71,39,32,0,0,0
2022-03-08 16:15,80,37,43,0,0,0
2022-03-08 16:30,74,41,33,0,0,0
2022-03-08 16:45,72,37,35,0,0,0
2022-03-08 17:00,81,47,34,0,0,0
2022-03-08 17:15,78,40,38,0,0,0
2022-03-08 17:30,75,41,34,0,0,0
2022-03-08 17:45,64,34,30,0,0,0
2022-03-08 18:00,57,27,30,0,0,0
2022-03-08 18:15,74,26,48,0,0,0
2022-03-08 18:30,42,18,24,0,0,0
2022-03-08 18:45,43,25,18,0,0,0
2022-03-08 19:00,40,19,21,0,0,0
2022-03-08 19:15,34,21,13,0,0,0
2022-03-08 19:30,19,8,11,0,0,0
2022-03-08 19:45,21,9,12,0,0,0
2022-03-08 20:00,28,13,15,0,0,0
2022-03-08 20:15,26,14,12,0,0,0
2022-03-08 20:30,12,3,9,0,0,0
2022-03-08 20:45,21,4,17,0,0,0
2022-03-08 21:00,12,5,7,0,0,0
2022-03-08 21:15,18,7,11,0,0,0
2022-03-08 21:30,13,4,9,0,0,0
2022-03-08 21:45,10,3,7,0,0,0
2022-03-08 22:00,5,1,4,0,0,0
2022-03-08 22:15,13,4,9,0,0,0
2022-03-08 22:30,14,2,12,0,0,0
2022-03-08 22:45,6,2,4,0,0,0
2022-03-08 23:00,7,2,5,0,0,0
2022-03-08 23:15,5,3,2,0,0,0
2022-03-08 23:30,8,2,6,0,0,0
2022-03-08 23:45,2,0,2,0,0,0
2022-03-09 00:00,1,1,0,0,0,0
2022-03-09 00:15,2,0,2,0,0,0
2022-03-09 00:30,0,0,0,0,0,0
2022-03-09 00:45,1,0,1,0,0,0
2022-03-09 01:00,0,0,0,0,0,0
2022-03-09 01:15,1,0,1,0,0,0
2022-03-09 01:30,0,0,0,0,0,0
2022-03-09 01:45,2,0,2,0,0,0
2022-03-09 02:00,0,0,0,0,0,0
2022-03-09 02:15,2,0,2,0,0,0
2022-03-09 02:30,2,2,0,0,0,0
2022-03-09 02:45,3,1,2,0,0,0
2022-03-09 03:00,1,1,0,0,0,0
2022-03-09 03:15,2,0,2,0,0,0
2022-03-09 03:30,0,0,0,0,0,0
2022-03-09 03:45,0,0,0,0,0,0
2022-03-09 04:00,1,0,1,0,0,0
2022-03-09 04:15,1,1,0,0,0,0
2022-03-09 04:30,2,2,0,0,0,0
2022-03-09 04:45,4,4,0,0,0,0
2022-03-09 05:00,2,2,0,0,0,0
2022-03-09 05:15,4,4,0,0,0,0
2022-03-09 05:30,7,3,4,0,0,0
2022-03-09 05:45,13,7,6,0,0,0
2022-03-09 06:00,8,3,5,0,0,0
2022-03-09 06:15,23,7,16,0,0,0
2022-03-09 06:30,34,22,12,0,0,0
2022-03-09 06:45,30,15,15,0,0,0
2022-03-09 07:00,38,25,13,0,0,0
2022-03-09 07:15,76,61,15,0,0,0
2022-03-09 07:30,146,112,34,0,0,0
2022-03-09 07:45,86,63,23,0,0,0
2022-03-09 08:00,77,50,27,0,0,0
2022-03-09 08:15,51,36,15,0,0,0
2022-03-09 08:30,49,39,10,0,0,0
2022-03-09 08:45,53,37,16,0,0,0
2022-03-09 09:00,42,29,13,0,0,0
2022-03-09 09:15,53,42,11,0,0,0
2022-03-09 09:30,34,20,14,0,0,0
2022-03-09 09:45,47,35,12,0,0,0
2022-03-09 10:00,37,28,9,0,0,0
2022-03-09 10:15,26,12,14,0,0,0
2022-03-09 10:30,37,24,13,0,0,0
2022-03-09 10:45,60,47,13,0,0,0
2022-03-09 11:00,51,35,16,0,0,0
2022-03-09 11:15,51,29,22,0,0,0
2022-03-09 11:30,43,16,27,0,0,0
2022-03-09 11:45,46,26,20,0,0,0
2022-03-09 12:00,53,28,25,0,0,0
2022-03-09 12:15,52,31,21,0,0,0
2022-03-09 12:30,50,17,33,0,0,0
2022-03-09 12:45,55,25,30,0,0,0
2022-03-09 13:00,58,25,33,0,0,0
2022-03-09 13:15,64,26,38,0,0,0
2022-03-09 13:30,55,30,25,0,0,0
2022-03-09 13:45,43,19,24,0,0,0
2022-03-09 14:00,41,15,26,0,0,0
2022-03-09 14:15,55,25,30,0,0,0
2022-03-09 14:30,49,27,22,0,0,0
2022-03-09 14:45,52,21,31,0,0,0
2022-03-09 15:00,55,27,28,0,0,0
2022-03-09 15:15,68,34,34,0,0,0
2022-03-09 15:30,58,25,33,0,0,0
2022-03-09 15:45,85,53,32,0,0,0
2022-03-09 16:00,86,49,37,0,0,0
2022-03-09 16:15,79,53,26,0,0,0
2022-03-09 16:30,56,33,23,0,0,0
2022-03-09 16:45,91,52,39,0,0,0
2022-03-09 17:00,64,33,31,0,0,0
2022-03-09 17:15,79,39,40,0,0,0
2022-03-09 17:30,67,41,26,0,0,0
2022-03-09 17:45,85,53,32,0,0,0
2022-03-09 18:00,53,23,30,0,0,0
2022-03-09 18:15,51,34,17,0,0,0
2022-03-09 18:30,56,23,33,0,0,0
2022-03-09 18:45,60,32,28,0,0,0
2022-03-09 19:00,36,14,22,0,0,0
2022-03-09 19:15,32,15,17,0,0,0
2022-03-09 19:30,33,17,16,0,0,0
2022-03-09 19:45,34,19,15,0,0,0
2022-03-09 20:00,25,9,16,0,0,0
2022-03-09 20:15,22,11,11,0,0,0
2022-03-09 20:30,24,10,14,0,0,0
2022-03-09 20:45,15,5,10,0,0,0
2022-03-09 21:00,14,8,6,0,0,0
2022-03-09 21:15,18,6,12,0,0,0
2022-03-09 21:30,7,2,5,0,0,0
2022-03-09 21:45,6,3,3,0,0,0
2022-03-09 22:00,13,0,13,0,0,0
2022-03-09 22:15,17,6,11,0,0,0
2022-03-09 22:30,6,1,5,0,0,0
2022-03-09 22:45,9,4,5,0,0,0
2022-03-09 23:00,6,2,4,0,0,0
2022-03-09 23:15,3,0,3,0,0,0
2022-03-09 23:30,4,1,3,0,0,0
2022-03-09 23:45,4,3,1,0,0,0
2022-03-10 00:00,2,0,2,0,0,0
2022-03-10 00:15,1,0,1,0,0,0
2022-03-10 00:30,0,0,0,0,0,0
2022-03-10 00:45,2,0,2,0,0,0
2022-03-10 01:00,0,0,0,0,0,0
2022-03-10 01:15,0,0,0,0,0,0
2022-03-10 01:30,0,0,0,0,0,0
2022-03-10 01:45,1,0,1,0,0,0
2022-03-10 02:00,0,0,0,0,0,0
2022-03-10 02:15,2,0,2,0,0,0
2022-03-10 02:30,1,0,1,0,0,0
2022-03-10 02:45,3,0,3,0,0,0
2022-03-10 03:00,0,0,0,0,0,0
2022-03-10 03:15,1,0,1,0,0,0
2022-03-10 03:30,1,1,0,0,0,0
2022-03-10 03:45,2,1,1,0,0,0
2022-03-10 04:00,1,1,0,0,0,0
2022-03-10 04:15,2,1,1,0,0,0
2022-03-10 04:30,0,0,0,0,0,0
2022-03-10 04:45,3,2,1,0,0,0
2022-03-10 05:00,1,1,0,0,0,0
2022-03-10 05:15,5,2,3,0,0,0
2022-03-10 05:30,3,2,1,0,0,0
2022-03-10 05:45,13,4,9,0,0,0
2022-03-10 06:00,9,4,5,0,0,0
2022-03-10 06:15,21,10,11,0,0,0
2022-03-10 06:30,32,17,15,0,0,0
2022-03-10 06:45,31,14,17,0,0,0
2022-03-10 07:00,42,27,15,0,0,0
2022-03-10 07:15,94,74,20,0,0,0
2022-03-10 07:30,138,116,22,0,0,0
2022-03-10 07:45,107,69,38,0,0,0
2022-03-10 08:00,63,41,22,0,0,0
2022-03-10 08:15,60,38,22,0,0,0
2022-03-10 08:30,45,31,14,0,0,0
2022-03-10 08:45,39,22,17,0,0,0
2022-03-10 09:00,51,31,20,0,0,0
2022-03-10 09:15,26,11,15,0,0,0
2022-03-10 09:30,36,20,16,0,0,0
2022-03-10 09:45,30,18,12,0,0,0
2022-03-10 10:00,30,24,6,0,0,0
2022-03-10 10:15,36,22,14,0,0,0
2022-03-10 10:30,35,18,17,0,0,0
2022-03-10 10:45,45,29,16,0,0,0
2022-03-10 11:00,39,22,17,0,0,0
2022-03-10 11:15,41,25,16,0,0,0
2022-03-10 11:30,43,21,22,0,0,0
2022-03-10 11:45,50,28,22,0,0,0
2022-03-10 12:00,29,15,14,0,0,0
2022-03-10 12:15,53,29,24,0,0,0
2022-03-10 12:30,48,23,25,0,0,0
2022-03-10 12:45,50,32,18,0,0,0
2022-03-10 13:00,61,26,35,0,0,0
2022-03-10 13:15,61,28,33,0,0,0
2022-03-10 13:30,47,20,27,0,0,0
2022-03-10 13:45,60,18,42,0,0,0
2022-03-10 14:00,71,26,45,0,0,0
2022-03-10 14:15,48,30,18,0,0,0
2022-03-10 14:30,45,30,15,0,0,0
2022-03-10 14:45,89,51,38,0,0,0
2022-03-10 15:00,84,43,41,0,0,0
2022-03-10 15:15,67,33,34,0,0,0
2022-03-10 15:30,70,39,31,0,0,0
2022-03-10 15:45,86,45,41,0,0,0
2022-03-10 16:00,76,39,37,0,0,0
2022-03-10 16:15,92,47,45,0,0,0
2022-03-10 16:30,84,45,39,0,0,0
2022-03-10 16:45,73,36,37,0,0,0
2022-03-10 17:00,80,36,44,0,0,0
2022-03-10 17:15,77,46,31,0,0,0
2022-03-10 17:30,76,41,35,0,0,0
2022-03-10 17:45,72,42,30,0,0,0
2022-03-10 18:00,74,35,39,0,0,0
2022-03-10 18:15,59,36,23,0,0,0
2022-03-10 18:30,47,20,27,0,0,0
2022-03-10 18:45,49,27,22,0,0,0
2022-03-10 19:00,35,16,19,0,0,0
2022-03-10 19:15,34,15,19,0,0,0
2022-03-10 19:30,34,10,24,0,0,0
2022-03-10 19:45,38,13,25,0,0,0
2022-03-10 20:00,20,6,14,0,0,0
2022-03-10 20:15,20,7,13,0,0,0
2022-03-10 20:30,17,6,11,0,0,0
2022-03-10 20:45,13,8,5,0,0,0
2022-03-10 21:00,12,7,5,0,0,0
2022-03-10 21:15,12,4,8,0,0,0
2022-03-10 21:30,15,3,12,0,0,0
2022-03-10 21:45,19,6,13,0,0,0
2022-03-10 22:00,14,3,11,0,0,0
2022-03-10 22:15,13,5,8,0,0,0
2022-03-10 22:30,9,7,2,0,0,0
2022-03-10 22:45,9,3,6,0,0,0
2022-03-10 23:00,9,2,7,0,0,0
2022-03-10 23:15,6,1,5,0,0,0
2022-03-10 23:30,11,5,6,0,0,0
2022-03-10 23:45,4,0,4,0,0,0
2022-03-11 00:00,1,1,0,0,0,0
2022-03-11 00:15,4,1,3,0,0,0
2022-03-11 00:30,2,0,2,0,0,0
2022-03-11 00:45,0,0,0,0,0,0
2022-03-11 01:00,0,0,0,0,0,0
2022-03-11 01:15,1,0,1,0,0,0
2022-03-11 01:30,1,0,1,0,0,0
2022-03-11 01:45,1,0,1,0,0,0
2022-03-11 02:00,1,0,1,0,0,0
2022-03-11 02:15,3,0,3,0,0,0
2022-03-11 02:30,0,0,0,0,0,0
2022-03-11 02:45,1,0,1,0,0,0
2022-03-11 03:00,0,0,0,0,0,0
2022-03-11 03:15,1,0,1,0,0,0
2022-03-11 03:30,0,0,0,0,0,0
2022-03-11 03:45,0,0,0,0,0,0
2022-03-11 04:00,2,1,1,0,0,0
2022-03-11 04:15,1,1,0,0,0,0
2022-03-11 04:30,1,1,0,0,0,0
2022-03-11 04:45,3,3,0,0,0,0
2022-03-11 05:00,5,4,1,0,0,0
2022-03-11 05:15,2,1,1,0,0,0
2022-03-11 05:30,7,5,2,0,0,0
2022-03-11 05:45,15,6,9,0,0,0
2022-03-11 06:00,8,6,2,0,0,0
2022-03-11 06:15,23,9,14,0,0,0
2022-03-11 06:30,32,18,14,0,0,0
2022-03-11 06:45,38,18,20,0,0,0
2022-03-11 07:00,34,19,15,0,0,0
2022-03-11 07:15,69,55,14,0,0,0
2022-03-11 07:30,149,111,38,0,0,0
2022-03-11 07:45,78,62,16,0,0,0
2022-03-11 08:00,51,37,14,0,0,0
2022-03-11 08:15,67,43,24,0,0,0
2022-03-11 08:30,47,31,16,0,0,0
2022-03-11 08:45,47,33,14,0,0,0
2022-03-11 09:00,27,19,8,0,0,0
2022-03-11 09:15,36,28,8,0,0,0
2022-03-11 09:30,34,24,10,0,0,0
2022-03-11 09:45,38,27,11,0,0,0
2022-03-11 10:00,19,15,4,0,0,0
2022-03-11 10:15,38,26,12,0,0,0
2022-03-11 10:30,37,20,17,0,0,0
2022-03-11 10:45,36,22,14,0,0,0
2022-03-11 11:00,29,16,13,0,0,0
2022-03-11 11:15,31,18,13,0,0,0
2022-03-11 11:30,56,32,24,0,0,0
2022-03-11 11:45,40,26,14,0,0,0
2022-03-11 12:00,37,23,14,0,0,0
2022-03-11 12:15,43,22,21,0,0,0
2022-03-11 12:30,42,21,21,0,0,0
2022-03-11 12:45,54,32,22,0,0,0
2022-03-11 13:00,54,22,32,0,0,0
2022-03-11 13:15,59,30,29,0,0,0
2022-03-11 13:30,47,23,24,0,0,0
2022-03-11 13:45,61,29,32,0,0,0
2022-03-11 14:00,78,33,45,0,0,0
2022-03-11 14:15,55,27,28,0,0,0
2022-03-11 14:30,56,32,24,0,0,0
2022-03-11 14:45,76,33,43,0,0,0
2022-03-11 15:00,66,34,32,0,0,0
2022-03-11 15:15,87,42,45,0,0,0
2022-03-11 15:30,88,43,45,0,0,0
2022-03-11 15:45,68,34,34,0,0,0
2022-03-11 16:00,49,28,21,0,0,0
2022-03-11 16:15,67,42,25,0,0,0
2022-03-11 16:30,48,27,21,0,0,0
2022-03-11 16:45,67,36,31,0,0,0
2022-03-11 17:00,59,37,22,0,0,0
2022-03-11 17:15,66,38,28,0,0,0
2022-03-11 17:30,58,30,28,0,0,0
2022-03-11 17:45,54,29,25,0,0,0
2022-03-11 18:00,55,33,22,0,0,0
2022-03-11 18:15,74,42,32,0,0,0
2022-03-11 18:30,51,31,20,0,0,0
2022-03-11 18:45,42,21,21,0,0,0
2022-03-11 19:00,48,23,25,0,0,0
2022-03-11 19:15,40,25,15,0,0,0
2022-03-11 19:30,31,13,18,0,0,0
2022-03-11 19:45,33,21,12,0,0,0
2022-03-11 20:00,24,16,8,0,0,0
2022-03-11 20:15,35,21,14,0,0,0
2022-03-11 20:30,21,8,13,0,0,0
2022-03-11 20:45,11,4,7,0,0,0
2022-03-11 21:00,30,13,17,0,0,0
2022-03-11 21:15,23,10,13,0,0,0
2022-03-11 21:30,13,8,5,0,0,0
2022-03-11 21:45,15,5,10,0,0,0
2022-03-11 22:00,17,2,15,0,0,0
2022-03-11 22:15,15,5,10,0,0,0
2022-03-11 22:30,15,3,12,0,0,0
2022-03-11 22:45,14,3,11,0,0,0
2022-03-11 23:00,12,3,9,0,0,0
2022-03-11 23:15,9,4,5,0,0,0
2022-03-11 23:30,17,7,10,0,0,0
2022-03-11 23:45,12,3,9,0,0,0
2022-03-12 00:00,11,5,6,0,0,0
2022-03-12 00:15,7,3,4,0,0,0
2022-03-12 00:30,5,1,4,0,0,0
2022-03-12 00:45,5,1,4,0,0,0
2022-03-12 01:00,0,0,0,0,0,0
2022-03-12 01:15,4,0,4,0,0,0
2022-03-12 01:30,7,4,3,0,0,0
2022-03-12 01:45,3,0,3,0,0,0
2022-03-12 02:00,3,2,1,0,0,0
2022-03-12 02:15,6,0,6,0,0,0
2022-03-12 02:30,1,0,1,0,0,0
2022-03-12 02:45,3,1,2,0,0,0
2022-03-12 03:00,6,4,2,0,0,0
2022-03-12 03:15,3,1,2,0,0,0
2022-03-12 03:30,1,1,0,0,0,0
2022-03-12 03:45,1,1,0,0,0,0
2022-03-12 04:00,0,0,0,0,0,0
2022-03-12 04:15,1,1,0,0,0,0
2022-03-12 04:30,0,0,0,0,0,0
2022-03-12 04:45,0,0,0,0,0,0
2022-03-12 05:00,0,0,0,0,0,0
2022-03-12 05:15,4,4,0,0,0,0
2022-03-12 05:30,1,0,1,0,0,0
2022-03-12 05:45,5,3,2,0,0,0
2022-03-12 06:00,2,1,1,0,0,0
2022-03-12 06:15,5,3,2,0,0,0
2022-03-12 06:30,3,3,0,0,0,0
2022-03-12 06:45,4,3,1,0,0,0
2022-03-12 07:00,4,2,2,0,0,0
2022-03-12 07:15,8,6,2,0,0,0
2022-03-12 07:30,12,10,2,0,0,0
2022-03-12 07:45,6,3,3,0,0,0
2022-03-12 08:00,14,10,4,0,0,0
2022-03-12 08:15,16,13,3,0,0,0
2022-03-12 08:30,20,14,6,0,0,0
2022-03-12 08:45,21,13,8,0,0,0
2022-03-12 09:00,29,20,9,0,0,0
2022-03-12 09:15,30,22,8,0,0,0
2022-03-12 09:30,40,31,9,0,0,0
2022-03-12 09:45,37,28,9,0,0,0
2022-03-12 10:00,40,32,8,0,0,0
2022-03-12 10:15,45,36,9,0,0,0
2022-03-12 10:30,64,42,22,0,0,0
2022-03-12 10:45,63,46,17,0,0,0
2022-03-12 11:00,58,43,15,0,0,0
2022-03-12 11:15,65,47,18,0,0,0
2022-03-12 11:30,48,37,11,0,0,0
2022-03-12 11:45,55,34,21,0,0,0
2022-03-12 12:00,75,44,31,0,0,0
2022-03-12 12:15,47,23,24,0,0,0
2022-03-12 12:30,56,26,30,0,0,0
2022-03-12 12:45,47,30,17,0,0,0
2022-03-12 13:00,41,23,18,0,0,0
2022-03-12 13:15,56,24,32,0,0,0
2022-03-12 13:30,64,31,33,0,0,0
2022-03-12 13:45,55,22,33,0,0,0
2022-03-12 14:00,43,24,19,0,0,0
2022-03-12 14:15,44,23,21,0,0,0
2022-03-12 14:30,66,34,32,0,0,0
2022-03-12 14:45,49,21,28,0,0,0
2022-03-12 15:00,59,33,26,0,0,0
2022-03-12 15:15,53,26,27,0,0,0
2022-03-12 15:30,44,27,17,0,0,0
2022-03-12 15:45,53,30,23,0,0,0
2022-03-12 16:00,36,20,16,0,0,0
2022-03-12 16:15,49,25,24,0,0,0
2022-03-12 16:30,42,24,18,0,0,0
2022-03-12 16:45,33,19,14,0,0,0
2022-03-12 17:00,45,17,28,0,0,0
2022-03-12 17:15,43,13,30,0,0,0
2022-03-12 17:30,42,20,22,0,0,0
2022-03-12 17:45,45,31,14,0,0,0
2022-03-12 18:00,48,20,28,0,0,0
2022-03-12 18:15,27,13,14,0,0,0
2022-03-12 18:30,48,28,20,0,0,0
2022-03-12 18:45,30,10,20,0,0,0
2022-03-12 19:00,43,27,16,0,0,0
2022-03-12 19:15,27,14,13,0,0,0
2022-03-12 19:30,23,11,12,0,0,0
2022-03-12 19:45,30,15,15,0,0,0
2022-03-12 20:00,17,6,11,0,0,0
2022-03-12 20:15,26,16,10,0,0,0
2022-03-12 20:30,11,1,10,0,0,0
2022-03-12 20:45,23,10,13,0,0,0
2022-03-12 21:00,20,9,11,0,0,0
2022-03-12 21:15,15,5,10,0,0,0
2022-03-12 21:30,13,9,4,0,0,0
2022-03-12 21:45,8,6,2,0,0,0
2022-03-12 22:00,17,3,14,0,0,0
2022-03-12 22:15,3,2,1,0,0,0
2022-03-12 22:30,4,0,4,0,0,0
2022-03-12 22:45,10,1,9,0,0,0
2022-03-12 23:00,12,5,7,0,0,0
2022-03-12 23:15,13,2,11,0,0,0
2022-03-12 23:30,12,5,7,0,0,0
2022-03-12 23:45,17,2,15,0,0,0
