Datetime,100034978 (Gartenstraße),101034978 (Gartenstraße einwärts),102034978 (Gartenstraße auswärts),100034978-status,101034978-status,102034978-status
2022-02-01 00:00,3,1,2,0,0,0
2022-02-01 00:15,5,1,4,0,0,0
2022-02-01 00:30,0,0,0,0,0,0
2022-02-01 00:45,0,0,0,0,0,0
2022-02-01 01:00,5,0,5,0,0,0
2022-02-01 01:15,0,0,0,0,0,0
2022-02-01 01:30,1,0,1,0,0,0
2022-02-01 01:45,0,0,0,0,0,0
2022-02-01 02:00,2,1,1,0,0,0
2022-02-01 02:15,1,0,1,0,0,0
2022-02-01 02:30,0,0,0,0,0,0
2022-02-01 02:45,0,0,0,0,0,0
2022-02-01 03:00,0,0,0,0,0,0
2022-02-01 03:15,3,3,0,0,0,0
2022-02-01 03:30,0,0,0,0,0,0
2022-02-01 03:45,0,0,0,0,0,0
2022-02-01 04:00,1,1,0,0,0,0
2022-02-01 04:15,2,2,0,0,0,0
2022-02-01 04:30,1,1,0,0,0,0
2022-02-01 04:45,3,2,1,0,0,0
2022-02-01 05:00,0,0,0,0,0,0
2022-02-01 05:15,2,2,0,0,0,0
2022-02-01 05:30,6,3,3,0,0,0
2022-02-01 05:45,13,4,9,0,0,0
2022-02-01 06:00,11,5,6,0,0,0
2022-02-01 06:15,18,6,12,0,0,0
2022-02-01 06:30,31,16,15,0,0,0
2022-02-01 06:45,38,18,20,0,0,0
2022-02-01 07:00,32,16,16,0,0,0
2022-02-01 07:15,61,45,16,0,0,0
2022-02-01 07:30,125,104,21,0,0,0
2022-02-01 07:45,70,50,20,0,0,0
2022-02-01 08:00,34,24,10,0,0,0
2022-02-01 08:15,39,23,16,0,0,0
2022-02-01 08:30,47,29,18,0,0,0
2022-02-01 08:45,46,31,15,0,0,0
2022-02-01 09:00,29,20,9,0,0,0
2022-02-01 09:15,35,23,12,0,0,0
2022-02-01 09:30,24,17,7,0,0,0
2022-02-01 09:45,26,19,7,0,0,0
2022-02-01 10:00,32,19,13,0,0,0
2022-02-01 10:15,21,16,5,0,0,0
2022-02-01 10:30,27,18,9,0,0,0
2022-02-01 10:45,22,12,10,0,0,0
2022-02-01 11:00,20,11,9,0,0,0
2022-02-01 11:15,23,14,9,0,0,0
2022-02-01 11:30,18,8,10,0,0,0
2022-02-01 11:45,27,14,13,0,0,0
2022-02-01 12:00,25,17,8,0,0,0
2022-02-01 12:15,40,22,18,0,0,0
2022-02-01 12:30,34,19,15,0,0,0
2022-02-01 12:45,26,11,15,0,0,0
2022-02-01 13:00,37,20,17,0,0,0
2022-02-01 13:15,43,16,27,0,0,0
2022-02-01 13:30,30,13,17,0,0,0
2022-02-01 13:45,33,19,14,0,0,0
2022-02-01 14:00,49,21,28,0,0,0
2022-02-01 14:15,28,14,14,0,0,0
2022-02-01 14:30,27,19,8,0,0,0
2022-02-01 14:45,32,21,11,0,0,0
2022-02-01 15:00,45,20,25,0,0,0
2022-02-01 15:15,46,18,28,0,0,0
2022-02-01 15:30,39,14,25,0,0,0
2022-02-01 15:45,36,20,16,0,0,0
2022-02-01 16:00,50,25,25,0,0,0
2022-02-01 16:15,59,34,25,0,0,0
2022-02-01 16:30,50,26,24,0,0,0
2022-02-01 16:45,60,38,22,0,0,0
2022-02-01 17:00,54,24,30,0,0,0
2022-02-01 17:15,41,23,18,0,0,0
2022-02-01 17:30,57,34,23,0,0,0
2022-02-01 17:45,54,32,22,0,0,0
2022-02-01 18:00,45,24,21,0,0,0
2022-02-01 18:15,46,22,24,0,0,0
2022-02-01 18:30,37,14,23,0,0,0
2022-02-01 18:45,37,20,17,0,0,0
2022-02-01 19:00,27,13,14,0,0,0
2022-02-01 19:15,18,8,10,0,0,0
2022-02-01 19:30,30,18,12,0,0,0
2022-02-01 19:45,18,9,9,0,0,0
2022-02-01 20:00,19,8,11,0,0,0
2022-02-01 20:15,9,3,6,0,0,0
2022-02-01 20:30,20,8,12,0,0,0
2022-02-01 20:45,13,6,7,0,0,0
2022-02-01 21:00,8,3,5,0,0,0
2022-02-01 21:15,4,2,2,0,0,0
2022-02-01 21:30,10,2,8,0,0,0
2022-02-01 21:45,12,4,8,0,0,0
2022-02-01 22:00,14,10,4,0,0,0
2022-02-01 22:15,10,3,7,0,0,0
2022-02-01 22:30,7,1,6,0,0,0
2022-02-01 22:45,3,0,3,0,0,0
2022-02-01 23:00,12,2,10,0,0,0
2022-02-01 23:15,1,0,1,0,0,0
2022-02-01 23:30,2,0,2,0,0,0
2022-02-01 23:45,3,0,3,0,0,0
2022-02-02 00:00,2,2,0,0,0,0
2022-02-02 00:15,1,0,1,0,0,0
2022-02-02 00:30,5,3,2,0,0,0
2022-02-02 00:45,0,0,0,0,0,0
2022-02-02 01:00,0,0,0,0,0,0
2022-02-02 01:15,1,0,1,0,0,0
2022-02-02 01:30,1,0,1,0,0,0
2022-02-02 01:45,1,1,0,0,0,0
2022-02-02 02:00,1,0,1,0,0,0
2022-02-02 02:15,1,0,1,0,0,0
2022-02-02 02:30,0,0,0,0,0,0
2022-02-02 02:45,2,0,2,0,0,0
2022-02-02 03:00,2,1,1,0,0,0
2022-02-02 03:15,1,1,0,0,0,0
2022-02-02 03:30,0,0,0,0,0,0
2022-02-02 03:45,0,0,0,0,0,0
2022-02-02 04:00,0,0,0,0,0,0
2022-02-02 04:15,2,2,0,0,0,0
2022-02-02 04:30,2,2,0,0,0,0
2022-02-02 04:45,4,3,1,0,0,0
2022-02-02 05:00,1,0,1,0,0,0
2022-02-02 05:15,3,2,1,0,0,0
2022-02-02 05:30,7,5,2,0,0,0
2022-02-02 05:45,11,6,5,0,0,0
2022-02-02 06:00,8,3,5,0,0,0
2022-02-02 06:15,20,10,10,0,0,0
2022-02-02 06:30,27,12,15,0,0,0
2022-02-02 06:45,24,13,11,0,0,0
2022-02-02 07:00,29,15,14,0,0,0
2022-02-02 07:15,61,44,17,0,0,0
2022-02-02 07:30,134,110,24,0,0,0
2022-02-02 07:45,92,64,28,0,0,0
2022-02-02 08:00,55,36,19,0,0,0
2022-02-02 08:15,40,28,12,0,0,0
2022-02-02 08:30,57,45,12,0,0,0
2022-02-02 08:45,38,22,16,0,0,0
2022-02-02 09:00,33,29,4,0,0,0
2022-02-02 09:15,41,31,10,0,0,0
2022-02-02 09:30,30,21,9,0,0,0
2022-02-02 09:45,54,39,15,0,0,0
2022-02-02 10:00,32,21,11,0,0,0
2022-02-02 10:15,35,25,10,0,0,0
2022-02-02 10:30,49,29,20,0,0,0
2022-02-02 10:45,40,23,17,0,0,0
2022-02-02 11:00,40,22,18,0,0,0
2022-02-02 11:15,55,30,25,0,0,0
2022-02-02 11:30,34,17,17,0,0,0
2022-02-02 11:45,52,26,26,0,0,0
2022-02-02 12:00,49,25,24,0,0,0
2022-02-02 12:15,42,21,21,0,0,0
2022-02-02 12:30,60,22,38,0,0,0
2022-02-02 12:45,60,36,24,0,0,0
2022-02-02 13:00,40,18,22,0,0,0
2022-02-02 13:15,49,23,26,0,0,0
2022-02-02 13:30,25,12,13,0,0,0
2022-02-02 13:45,48,14,34,0,0,0
2022-02-02 14:00,65,29,36,0,0,0
2022-02-02 14:15,38,19,19,0,0,0
2022-02-02 14:30,38,15,23,0,0,0
2022-02-02 14:45,53,34,19,0,0,0
2022-02-02 15:00,53,28,25,0,0,0
2022-02-02 15:15,51,28,23,0,0,0
2022-02-02 15:30,63,38,25,0,0,0
2022-02-02 15:45,77,43,34,0,0,0
2022-02-02 16:00,53,37,16,0,0,0
2022-02-02 16:15,72,42,30,0,0,0
2022-02-02 16:30,51,22,29,0,0,0
2022-02-02 16:45,51,31,20,0,0,0
2022-02-02 17:00,60,26,34,0,0,0
2022-02-02 17:15,83,47,36,0,0,0
2022-02-02 17:30,54,36,18,0,0,0
2022-02-02 17:45,63,34,29,0,0,0
2022-02-02 18:00,52,29,23,0,0,0
2022-02-02 18:15,38,23,15,0,0,0
2022-02-02 18:30,40,20,20,0,0,0
2022-02-02 18:45,43,22,21,0,0,0
2022-02-02 19:00,36,13,23,0,0,0
2022-02-02 19:15,38,12,26,0,0,0
2022-02-02 19:30,46,17,29,0,0,0
2022-02-02 19:45,31,11,20,0,0,0
2022-02-02 20:00,31,12,19,0,0,0
2022-02-02 20:15,16,5,11,0,0,0
2022-02-02 20:30,14,4,10,0,0,0
2022-02-02 20:45,6,2,4,0,0,0
2022-02-02 21:00,11,5,6,0,0,0
2022-02-02 21:15,13,1,12,0,0,0
2022-02-02 21:30,20,12,8,0,0,0
2022-02-02 21:45,7,2,5,0,0,0
2022-02-02 22:00,10,2,8,0,0,0
2022-02-02 22:15,13,2,11,0,0,0
2022-02-02 22:30,9,2,7,0,0,0
2022-02-02 22:45,11,2,9,0,0,0
2022-02-02 23:00,10,1,9,0,0,0
2022-02-02 23:15,11,5,6,0,0,0
2022-02-02 23:30,4,0,4,0,0,0
2022-02-02 23:45,5,2,3,0,0,0
2022-02-03 00:00,2,1,1,0,0,0
2022-02-03 00:15,5,4,1,0,0,0
2022-02-03 00:30,0,0,0,0,0,0
2022-02-03 00:45,2,0,2,0,0,0
2022-02-03 01:00,0,0,0,0,0,0
2022-02-03 01:15,4,1,3,0,0,0
2022-02-03 01:30,2,0,2,0,0,0
2022-02-03 01:45,1,1,0,0,0,0
2022-02-03 02:00,0,0,0,0,0,0
2022-02-03 02:15,1,0,1,0,0,0
2022-02-03 02:30,0,0,0,0,0,0
2022-02-03 02:45,2,0,2,0,0,0
2022-02-03 03:00,2,1,1,0,0,0
2022-02-03 03:15,1,1,0,0,0,0
2022-02-03 03:30,0,0,0,0,0,0
2022-02-03 03:45,0,0,0,0,0,0
2022-02-03 04:00,0,0,0,0,0,0
2022-02-03 04:15,2,2,0,0,0,0
2022-02-03 04:30,1,1,0,0,0,0
2022-02-03 04:45,3,1,2,0,0,0
2022-02-03 05:00,1,0,1,0,0,0
2022-02-03 05:15,6,6,0,0,0,0
2022-02-03 05:30,4,2,2,0,0,0
2022-02-03 05:45,15,5,10,0,0,0
2022-02-03 06:00,6,2,4,0,0,0
2022-02-03 06:15,21,9,12,0,0,0
2022-02-03 06:30,29,11,18,0,0,0
2022-02-03 06:45,35,17,18,0,0,0
2022-02-03 07:00,26,16,10,0,0,0
2022-02-03 07:15,62,50,12,0,0,0
2022-02-03 07:30,141,114,27,0,0,0
2022-02-03 07:45,74,52,22,0,0,0
2022-02-03 08:00,44,31,13,0,0,0
2022-02-03 08:15,42,31,11,0,0,0
2022-02-03 08:30,38,21,17,0,0,0
2022-02-03 08:45,40,26,14,0,0,0
2022-02-03 09:00,30,25,5,0,0,0
2022-02-03 09:15,28,15,13,0,0,0
2022-02-03 09:30,31,23,8,0,0,0
2022-02-03 09:45,44,25,19,0,0,0
2022-02-03 10:00,29,16,13,0,0,0
2022-02-03 10:15,23,13,10,0,0,0
2022-02-03 10:30,21,12,9,0,0,0
2022-02-03 10:45,29,18,11,0,0,0
2022-02-03 11:00,26,12,14,0,0,0
2022-02-03 11:15,31,19,12,0,0,0
2022-02-03 11:30,22,13,9,0,0,0
2022-02-03 11:45,31,19,12,0,0,0
2022-02-03 12:00,37,20,17,0,0,0
2022-02-03 12:15,37,20,17,0,0,0
2022-02-03 12:30,38,14,24,0,0,0
2022-02-03 12:45,42,27,15,0,0,0
2022-02-03 13:00,38,13,25,0,0,0
2022-02-03 13:15,46,16,30,0,0,0
2022-02-03 13:30,41,25,16,0,0,0
2022-02-03 13:45,46,24,22,0,0,0
2022-02-03 14:00,44,20,24,0,0,0
2022-02-03 14:15,38,25,13,0,0,0
2022-02-03 14:30,49,29,20,0,0,0
2022-02-03 14:45,59,30,29,0,0,0
2022-02-03 15:00,44,25,19,0,0,0
2022-02-03 15:15,58,30,28,0,0,0
2022-02-03 15:30,58,27,31,0,0,0
2022-02-03 15:45,61,31,30,0,0,0
2022-02-03 16:00,81,40,41,0,0,0
2022-02-03 16:15,61,37,24,0,0,0
2022-02-03 16:30,79,37,42,0,0,0
2022-02-03 16:45,76,40,36,0,0,0
2022-02-03 17:00,69,38,31,0,0,0
2022-02-03 17:15,58,32,26,0,0,0
2022-02-03 17:30,52,23,29,0,0,0
2022-02-03 17:45,52,29,23,0,0,0
2022-02-03 18:00,50,21,29,0,0,0
2022-02-03 18:15,38,21,17,0,0,0
2022-02-03 18:30,36,18,18,0,0,0
2022-02-03 18:45,32,13,19,0,0,0
2022-02-03 19:00,33,11,22,0,0,0
2022-02-03 19:15,44,18,26,0,0,0
2022-02-03 19:30,29,6,23,0,0,0
2022-02-03 19:45,33,6,27,0,0,0
2022-02-03 20:00,17,6,11,0,0,0
2022-02-03 20:15,16,8,8,0,0,0
2022-02-03 20:30,11,8,3,0,0,0
2022-02-03 20:45,13,2,11,0,0,0
2022-02-03 21:00,10,3,7,0,0,0
2022-02-03 21:15,13,5,8,0,0,0
2022-02-03 21:30,22,15,7,0,0,0
2022-02-03 21:45,18,7,11,0,0,0
2022-02-03 22:00,9,4,5,0,0,0
2022-02-03 22:15,6,1,5,0,0,0
2022-02-03 22:30,7,2,5,0,0,0
2022-02-03 22:45,7,3,4,0,0,0
2022-02-03 23:00,8,4,4,0,0,0
2022-02-03 23:15,8,3,5,0,0,0
2022-02-03 23:30,4,3,1,0,0,0
2022-02-03 23:45,5,5,0,0,0,0
2022-02-04 00:00,6,1,5,0,0,0
2022-02-04 00:15,3,2,1,0,0,0
2022-02-04 00:30,2,0,2,0,0,0
2022-02-04 00:45,2,0,2,0,0,0
2022-02-04 01:00,0,0,0,0,0,0
2022-02-04 01:15,2,0,2,0,0,0
2022-02-04 01:30,2,0,2,0,0,0
2022-02-04 01:45,1,1,0,0,0,0
2022-02-04 02:00,1,0,1,0,0,0
2022-02-04 02:15,1,0,1,0,0,0
2022-02-04 02:30,0,0,0,0,0,0
2022-02-04 02:45,0,0,0,0,0,0
2022-02-04 03:00,0,0,0,0,0,0
2022-02-04 03:15,2,2,0,0,0,0
2022-02-04 03:30,0,0,0,0,0,0
2022-02-04 03:45,0,0,0,0,0,0
2022-02-04 04:00,1,1,0,0,0,0
2022-02-04 04:15,1,1,0,0,0,0
2022-02-04 04:30,1,1,0,0,0,0
2022-02-04 04:45,3,2,1,0,0,0
2022-02-04 05:00,0,0,0,0,0,0
2022-02-04 05:15,2,2,0,0,0,0
2022-02-04 05:30,6,4,2,0,0,0
2022-02-04 05:45,12,3,9,0,0,0
2022-02-04 06:00,9,5,4,0,0,0
2022-02-04 06:15,16,8,8,0,0,0
2022-02-04 06:30,31,17,14,0,0,0
2022-02-04 06:45,23,13,10,0,0,0
2022-02-04 07:00,26,15,11,0,0,0
2022-02-04 07:15,61,46,15,0,0,0
2022-02-04 07:30,118,93,25,0,0,0
2022-02-04 07:45,76,48,28,0,0,0
2022-02-04 08:00,41,24,17,0,0,0
2022-02-04 08:15,53,40,13,0,0,0
2022-02-04 08:30,40,27,13,0,0,0
2022-02-04 08:45,42,27,15,0,0,0
2022-02-04 09:00,37,31,6,0,0,0
2022-02-04 09:15,27,18,9,0,0,0
2022-02-04 09:30,33,22,11,0,0,0
2022-02-04 09:45,34,21,13,0,0,0
2022-02-04 10:00,30,17,13,0,0,0
2022-02-04 10:15,32,20,12,0,0,0
2022-02-04 10:30,32,19,13,0,0,0
2022-02-04 10:45,22,15,7,0,0,0
2022-02-04 11:00,24,14,10,0,0,0
2022-02-04 11:15,22,11,11,0,0,0
2022-02-04 11:30,27,14,13,0,0,0
2022-02-04 11:45,25,16,9,0,0,0
2022-02-04 12:00,28,20,8,0,0,0
2022-02-04 12:15,35,17,18,0,0,0
2022-02-04 12:30,36,14,22,0,0,0
2022-02-04 12:45,34,18,16,0,0,0
2022-02-04 13:00,59,22,37,0,0,0
2022-02-04 13:15,57,20,37,0,0,0
2022-02-04 13:30,42,20,22,0,0,0
2022-02-04 13:45,47,25,22,0,0,0
2022-02-04 14:00,60,24,36,0,0,0
2022-02-04 14:15,58,31,27,0,0,0
2022-02-04 14:30,35,17,18,0,0,0
2022-02-04 14:45,46,26,20,0,0,0
2022-02-04 15:00,47,19,28,0,0,0
2022-02-04 15:15,46,26,20,0,0,0
2022-02-04 15:30,45,19,26,0,0,0
2022-02-04 15:45,50,31,19,0,0,0
2022-02-04 16:00,47,20,27,0,0,0
2022-02-04 16:15,32,19,13,0,0,0
2022-02-04 16:30,42,19,23,0,0,0
2022-02-04 16:45,36,21,15,0,0,0
2022-02-04 17:00,32,17,15,0,0,0
2022-02-04 17:15,37,17,20,0,0,0
2022-02-04 17:30,31,16,15,0,0,0
2022-02-04 17:45,25,14,11,0,0,0
2022-02-04 18:00,31,13,18,0,0,0
2022-02-04 18:15,37,19,18,0,0,0
2022-02-04 18:30,27,16,11,0,0,0
2022-02-04 18:45,22,14,8,0,0,0
2022-02-04 19:00,33,20,13,0,0,0
2022-02-04 19:15,20,10,10,0,0,0
2022-02-04 19:30,28,16,12,0,0,0
2022-02-04 19:45,13,8,5,0,0,0
2022-02-04 20:00,20,4,16,0,0,0
2022-02-04 20:15,9,3,6,0,0,0
2022-02-04 20:30,18,12,6,0,0,0
2022-02-04 20:45,15,11,4,0,0,0
2022-02-04 21:00,13,7,6,0,0,0
2022-02-04 21:15,13,8,5,0,0,0
2022-02-04 21:30,8,2,6,0,0,0
2022-02-04 21:45,14,7,7,0,0,0
2022-02-04 22:00,14,4,10,0,0,0
2022-02-04 22:15,13,3,10,0,0,0
2022-02-04 22:30,4,0,4,0,0,0
2022-02-04 22:45,6,3,3,0,0,0
2022-02-04 23:00,6,5,1,0,0,0
2022-02-04 23:15,9,4,5,0,0,0
2022-02-04 23:30,8,1,7,0,0,0
2022-02-04 23:45,1,1,0,0,0,0
2022-02-05 00:00,7,6,1,0,0,0
2022-02-05 00:15,5,2,3,0,0,0
2022-02-05 00:30,8,3,5,0,0,0
2022-02-05 00:45,5,2,3,0,0,0
2022-02-05 01:00,5,4,1,0,0,0
2022-02-05 01:15,2,1,1,0,0,0
2022-02-05 01:30,3,0,3,0,0,0
2022-02-05 01:45,4,0,4,0,0,0
2022-02-05 02:00,0,0,0,0,0,0
2022-02-05 02:15,3,1,2,0,0,0
2022-02-05 02:30,8,2,6,0,0,0
2022-02-05 02:45,1,1,0,0,0,0
2022-02-05 03:00,0,0,0,0,0,0
2022-02-05 03:15,3,0,3,0,0,0
2022-02-05 03:30,3,2,1,0,0,0
2022-02-05 03:45,4,0,4,0,0,0
2022-02-05 04:00,0,0,0,0,0,0
2022-02-05 04:15,3,1,2,0,0,0
2022-02-05 04:30,1,1,0,0,0,0
2022-02-05 04:45,2,1,1,0,0,0
2022-02-05 05:00,2,0,2,0,0,0
2022-02-05 05:15,3,2,1,0,0,0
2022-02-05 05:30,5,3,2,0,0,0
2022-02-05 05:45,2,2,0,0,0,0
2022-02-05 06:00,3,3,0,0,0,0
2022-02-05 06:15,2,2,0,0,0,0
2022-02-05 06:30,4,3,1,0,0,0
2022-02-05 06:45,5,4,1,0,0,0
2022-02-05 07:00,6,4,2,0,0,0
2022-02-05 07:15,8,3,5,0,0,0
2022-02-05 07:30,6,4,2,0,0,0
2022-02-05 07:45,11,7,4,0,0,0
2022-02-05 08:00,8,5,3,0,0,0
2022-02-05 08:15,12,6,6,0,0,0
2022-02-05 08:30,12,11,1,0,0,0
2022-02-05 08:45,19,16,3,0,0,0
2022-02-05 09:00,21,14,7,0,0,0
2022-02-05 09:15,23,16,7,0,0,0
2022-02-05 09:30,32,27,5,0,0,0
2022-02-05 09:45,38,32,6,0,0,0
2022-02-05 10:00,35,29,6,0,0,0
2022-02-05 10:15,46,37,9,0,0,0
2022-02-05 10:30,46,29,17,0,0,0
2022-02-05 10:45,50,37,13,0,0,0
2022-02-05 11:00,43,23,20,0,0,0
2022-02-05 11:15,59,43,16,0,0,0
2022-02-05 11:30,47,36,11,0,0,0
2022-02-05 11:45,46,27,19,0,0,0
2022-02-05 12:00,53,31,22,0,0,0
2022-02-05 12:15,48,26,22,0,0,0
2022-02-05 12:30,57,32,25,0,0,0
2022-02-05 12:45,53,25,28,0,0,0
2022-02-05 13:00,48,21,27,0,0,0
2022-02-05 13:15,52,28,24,0,0,0
2022-02-05 13:30,31,13,18,0,0,0
2022-02-05 13:45,45,22,23,0,0,0
2022-02-05 14:00,41,16,25,0,0,0
2022-02-05 14:15,27,11,16,0,0,0
2022-02-05 14:30,49,14,35,0,0,0
2022-02-05 14:45,33,20,13,0,0,0
2022-02-05 15:00,43,22,21,0,0,0
2022-02-05 15:15,30,8,22,0,0,0
2022-02-05 15:30,40,19,21,0,0,0
2022-02-05 15:45,39,21,18,0,0,0
2022-02-05 16:00,24,17,7,0,0,0
2022-02-05 16:15,27,11,16,0,0,0
2022-02-05 16:30,33,15,18,0,0,0
2022-02-05 16:45,46,27,19,0,0,0
2022-02-05 17:00,32,19,13,0,0,0
2022-02-05 17:15,27,15,12,0,0,0
2022-02-05 17:30,24,14,10,0,0,0
2022-02-05 17:45,24,12,12,0,0,0
2022-02-05 18:00,32,10,22,0,0,0
2022-02-05 18:15,31,14,17,0,0,0
2022-02-05 18:30,29,14,15,0,0,0
2022-02-05 18:45,34,19,15,0,0,0
2022-02-05 19:00,40,25,15,0,0,0
2022-02-05 19:15,24,14,10,0,0,0
2022-02-05 19:30,14,9,5,0,0,0
2022-02-05 19:45,27,13,14,0,0,0
2022-02-05 20:00,21,9,12,0,0,0
2022-02-05 20:15,14,3,11,0,0,0
2022-02-05 20:30,13,9,4,0,0,0
2022-02-05 20:45,17,7,10,0,0,0
2022-02-05 21:00,12,3,9,0,0,0
2022-02-05 21:15,6,2,4,0,0,0
2022-02-05 21:30,12,7,5,0,0,0
2022-02-05 21:45,11,6,5,0,0,0
2022-02-05 22:00,15,2,13,0,0,0
2022-02-05 22:15,12,2,10,0,0,0
2022-02-05 22:30,16,6,10,0,0,0
2022-02-05 22:45,12,1,11,0,0,0
2022-02-05 23:00,2,1,1,0,0,0
2022-02-05 23:15,9,1,8,0,0,0
2022-02-05 23:30,5,2,3,0,0,0
2022-02-05 23:45,6,2,4,0,0,0
