Datetime,100034983 (Warendorfer Straße),101034983 (Warendorfer Straße stadteinwärts),102034983 (Warendorfer Straße stadtauswärts),100034983-status,101034983-status,102034983-status
2022-03-01 00:00,10,2,8,0,0,0
2022-03-01 00:15,4,2,2,0,0,0
2022-03-01 00:30,5,2,3,0,0,0
2022-03-01 00:45,5,1,4,0,0,0
2022-03-01 01:00,5,2,3,0,0,0
2022-03-01 01:15,4,1,3,0,0,0
2022-03-01 01:30,6,1,5,0,0,0
2022-03-01 01:45,2,0,2,0,0,0
2022-03-01 02:00,3,1,2,0,0,0
2022-03-01 02:15,2,1,1,0,0,0
2022-03-01 02:30,2,0,2,0,0,0
2022-03-01 02:45,2,2,0,0,0,0
2022-03-01 03:00,4,0,4,0,0,0
2022-03-01 03:15,3,1,2,0,0,0
2022-03-01 03:30,2,2,0,0,0,0
2022-03-01 03:45,0,0,0,0,0,0
2022-03-01 04:00,1,0,1,0,0,0
2022-03-01 04:15,2,2,0,0,0,0
2022-03-01 04:30,0,0,0,0,0,0
2022-03-01 04:45,1,1,0,0,0,0
2022-03-01 05:00,1,1,0,0,0,0
2022-03-01 05:15,2,1,1,0,0,0
2022-03-01 05:30,14,11,3,0,0,0
2022-03-01 05:45,18,7,11,0,0,0
2022-03-01 06:00,17,9,8,0,0,0
2022-03-01 06:15,24,16,8,0,0,0
2022-03-01 06:30,46,25,21,0,0,0
2022-03-01 06:45,52,36,16,0,0,0
2022-03-01 07:00,91,61,30,0,0,0
2022-03-01 07:15,81,47,34,0,0,0
2022-03-01 07:30,147,102,45,0,0,0
2022-03-01 07:45,151,106,45,0,0,0
2022-03-01 08:00,123,92,31,0,0,0
2022-03-01 08:15,131,91,40,0,0,0
2022-03-01 08:30,129,95,34,0,0,0
2022-03-01 08:45,155,100,55,0,0,0
2022-03-01 09:00,83,60,23,0,0,0
2022-03-01 09:15,79,56,23,0,0,0
2022-03-01 09:30,107,87,20,0,0,0
2022-03-01 09:45,92,60,32,0,0,0
2022-03-01 10:00,83,59,24,0,0,0
2022-03-01 10:15,89,64,25,0,0,0
2022-03-01 10:30,88,62,26,0,0,0
2022-03-01 10:45,90,62,28,0,0,0
2022-03-01 11:00,60,39,21,0,0,0
2022-03-01 11:15,87,53,34,0,0,0
2022-03-01 11:30,87,50,37,0,0,0
2022-03-01 11:45,93,64,29,0,0,0
2022-03-01 12:00,117,58,59,0,0,0
2022-03-01 12:15,110,61,49,0,0,0
2022-03-01 12:30,89,55,34,0,0,0
2022-03-01 12:45,113,65,48,0,0,0
2022-03-01 13:00,117,77,40,0,0,0
2022-03-01 13:15,105,62,43,0,0,0
2022-03-01 13:30,106,56,50,0,0,0
2022-03-01 13:45,107,52,55,0,0,0
2022-03-01 14:00,112,66,46,0,0,0
2022-03-01 14:15,121,77,44,0,0,0
2022-03-01 14:30,122,68,54,0,0,0
2022-03-01 14:45,107,57,50,0,0,0
2022-03-01 15:00,115,62,53,0,0,0
2022-03-01 15:15,153,91,62,0,0,0
2022-03-01 15:30,149,85,64,0,0,0
2022-03-01 15:45,156,80,76,0,0,0
2022-03-01 16:00,165,87,78,0,0,0
2022-03-01 16:15,149,78,71,0,0,0
2022-03-01 16:30,171,79,92,0,0,0
2022-03-01 16:45,179,94,85,0,0,0
2022-03-01 17:00,159,81,78,0,0,0
2022-03-01 17:15,148,64,84,0,0,0
2022-03-01 17:30,163,87,76,0,0,0
2022-03-01 17:45,160,54,106,0,0,0
2022-03-01 18:00,128,67,61,0,0,0
2022-03-01 18:15,111,58,53,0,0,0
2022-03-01 18:30,102,40,62,0,0,0
2022-03-01 18:45,91,51,40,0,0,0
2022-03-01 19:00,89,38,51,0,0,0
2022-03-01 19:15,81,42,39,0,0,0
2022-03-01 19:30,64,22,42,0,0,0
2022-03-01 19:45,69,34,35,0,0,0
2022-03-01 20:00,66,28,38,0,0,0
2022-03-01 20:15,52,20,32,0,0,0
2022-03-01 20:30,41,20,21,0,0,0
2022-03-01 20:45,32,18,14,0,0,0
2022-03-01 21:00,35,16,19,0,0,0
2022-03-01 21:15,31,11,20,0,0,0
2022-03-01 21:30,32,15,17,0,0,0
2022-03-01 21:45,32,14,18,0,0,0
2022-03-01 22:00,58,24,34,0,0,0
2022-03-01 22:15,21,16,5,0,0,0
2022-03-01 22:30,23,5,18,0,0,0
2022-03-01 22:45,25,13,12,0,0,0
2022-03-01 23:00,14,4,10,0,0,0
2022-03-01 23:15,13,6,7,0,0,0
2022-03-01 23:30,9,7,2,0,0,0
2022-03-01 23:45,8,4,4,0,0,0
2022-03-02 00:00,10,2,8,0,0,0
2022-03-02 00:15,3,3,0,0,0,0
2022-03-02 00:30,4,0,4,0,0,0
2022-03-02 00:45,2,1,1,0,0,0
2022-03-02 01:00,4,2,2,0,0,0
2022-03-02 01:15,1,1,0,0,0,0
2022-03-02 01:30,3,3,0,0,0,0
2022-03-02 01:45,0,0,0,0,0,0
2022-03-02 02:00,0,0,0,0,0,0
2022-03-02 02:15,2,0,2,0,0,0
2022-03-02 02:30,0,0,0,0,0,0
2022-03-02 02:45,1,1,0,0,0,0
2022-03-02 03:00,3,1,2,0,0,0
2022-03-02 03:15,2,2,0,0,0,0
2022-03-02 03:30,0,0,0,0,0,0
2022-03-02 03:45,1,1,0,0,0,0
2022-03-02 04:00,0,0,0,0,0,0
2022-03-02 04:15,4,4,0,0,0,0
2022-03-02 04:30,2,2,0,0,0,0
2022-03-02 04:45,0,0,0,0,0,0
2022-03-02 05:00,3,2,1,0,0,0
2022-03-02 05:15,3,3,0,0,0,0
2022-03-02 05:30,5,4,1,0,0,0
2022-03-02 05:45,17,9,8,0,0,0
2022-03-02 06:00,20,9,11,0,0,0
2022-03-02 06:15,26,19,7,0,0,0
2022-03-02 06:30,41,22,19,0,0,0
2022-03-02 06:45,64,40,24,0,0,0
2022-03-02 07:00,94,66,28,0,0,0
2022-03-02 07:15,144,94,50,0,0,0
2022-03-02 07:30,179,142,37,0,0,0
2022-03-02 07:45,219,141,78,0,0,0
2022-03-02 08:00,140,104,36,0,0,0
2022-03-02 08:15,137,92,45,0,0,0
2022-03-02 08:30,155,108,47,0,0,0
2022-03-02 08:45,144,113,31,0,0,0
2022-03-02 09:00,123,96,27,0,0,0
2022-03-02 09:15,131,91,40,0,0,0
2022-03-02 09:30,103,76,27,0,0,0
2022-03-02 09:45,109,83,26,0,0,0
2022-03-02 10:00,81,64,17,0,0,0
2022-03-02 10:15,81,65,16,0,0,0
2022-03-02 10:30,96,64,32,0,0,0
2022-03-02 10:45,115,82,33,0,0,0
2022-03-02 11:00,112,78,34,0,0,0
2022-03-02 11:15,127,75,52,0,0,0
2022-03-02 11:30,117,73,44,0,0,0
2022-03-02 11:45,140,95,45,0,0,0
2022-03-02 12:00,142,80,62,0,0,0
2022-03-02 12:15,144,91,53,0,0,0
2022-03-02 12:30,113,69,44,0,0,0
2022-03-02 12:45,162,92,70,0,0,0
2022-03-02 13:00,129,72,57,0,0,0
2022-03-02 13:15,144,72,72,0,0,0
2022-03-02 13:30,134,77,57,0,0,0
2022-03-02 13:45,146,77,69,0,0,0
2022-03-02 14:00,137,67,70,0,0,0
2022-03-02 14:15,143,77,66,0,0,0
2022-03-02 14:30,116,62,54,0,0,0
2022-03-02 14:45,157,79,78,0,0,0
2022-03-02 15:00,133,78,55,0,0,0
2022-03-02 15:15,126,68,58,0,0,0
2022-03-02 15:30,136,71,65,0,0,0
2022-03-02 15:45,164,98,66,0,0,0
2022-03-02 16:00,145,71,74,0,0,0
2022-03-02 16:15,174,92,82,0,0,0
2022-03-02 16:30,185,93,92,0,0,0
2022-03-02 16:45,182,101,81,0,0,0
2022-03-02 17:00,148,62,86,0,0,0
2022-03-02 17:15,131,68,63,0,0,0
2022-03-02 17:30,133,60,73,0,0,0
2022-03-02 17:45,152,72,80,0,0,0
2022-03-02 18:00,151,74,77,0,0,0
2022-03-02 18:15,137,64,73,0,0,0
2022-03-02 18:30,117,42,75,0,0,0
2022-03-02 18:45,97,50,47,0,0,0
2022-03-02 19:00,95,48,47,0,0,0
2022-03-02 19:15,100,47,53,0,0,0
2022-03-02 19:30,67,27,40,0,0,0
2022-03-02 19:45,77,31,46,0,0,0
2022-03-02 20:00,81,41,40,0,0,0
2022-03-02 20:15,67,24,43,0,0,0
2022-03-02 20:30,32,12,20,0,0,0
2022-03-02 20:45,22,10,12,0,0,0
2022-03-02 21:00,41,20,21,0,0,0
2022-03-02 21:15,33,18,15,0,0,0
2022-03-02 21:30,35,20,15,0,0,0
2022-03-02 21:45,42,16,26,0,0,0
2022-03-02 22:00,34,9,25,0,0,0
2022-03-02 22:15,34,18,16,0,0,0
2022-03-02 22:30,30,6,24,0,0,0
2022-03-02 22:45,21,13,8,0,0,0
2022-03-02 23:00,30,7,23,0,0,0
2022-03-02 23:15,8,3,5,0,0,0
2022-03-02 23:30,13,8,5,0,0,0
2022-03-02 23:45,9,5,4,0,0,0
2022-03-03 00:00,6,0,6,0,0,0
2022-03-03 00:15,3,1,2,0,0,0
2022-03-03 00:30,6,5,1,0,0,0
2022-03-03 00:45,7,5,2,0,0,0
2022-03-03 01:00,23,16,7,0,0,0
2022-03-03 01:15,6,1,5,0,0,0
2022-03-03 01:30,4,1,3,0,0,0
2022-03-03 01:45,1,0,1,0,0,0
2022-03-03 02:00,2,1,1,0,0,0
2022-03-03 02:15,1,0,1,0,0,0
2022-03-03 02:30,1,1,0,0,0,0
2022-03-03 02:45,1,0,1,0,0,0
2022-03-03 03:00,2,0,2,0,0,0
2022-03-03 03:15,1,0,1,0,0,0
2022-03-03 03:30,2,2,0,0,0,0
2022-03-03 03:45,1,0,1,0,0,0
2022-03-03 04:00,0,0,0,0,0,0
2022-03-03 04:15,4,2,2,0,0,0
2022-03-03 04:30,1,1,0,0,0,0
2022-03-03 04:45,0,0,0,0,0,0
2022-03-03 05:00,3,2,1,0,0,0
2022-03-03 05:15,3,1,2,0,0,0
2022-03-03 05:30,12,8,4,0,0,0
2022-03-03 05:45,15,8,7,0,0,0
2022-03-03 06:00,23,13,10,0,0,0
2022-03-03 06:15,30,16,14,0,0,0
2022-03-03 06:30,42,24,18,0,0,0
2022-03-03 06:45,54,33,21,0,0,0
2022-03-03 07:00,80,54,26,0,0,0
2022-03-03 07:15,162,123,39,0,0,0
2022-03-03 07:30,322,275,47,0,0,0
2022-03-03 07:45,205,134,71,0,0,0
2022-03-03 08:00,118,80,38,0,0,0
2022-03-03 08:15,137,98,39,0,0,0
2022-03-03 08:30,130,104,26,0,0,0
2022-03-03 08:45,140,105,35,0,0,0
2022-03-03 09:00,105,80,25,0,0,0
2022-03-03 09:15,75,51,24,0,0,0
2022-03-03 09:30,66,51,15,0,0,0
2022-03-03 09:45,102,75,27,0,0,0
2022-03-03 10:00,66,44,22,0,0,0
2022-03-03 10:15,74,54,20,0,0,0
2022-03-03 10:30,80,55,25,0,0,0
2022-03-03 10:45,94,70,24,0,0,0
2022-03-03 11:00,66,33,33,0,0,0
2022-03-03 11:15,87,62,25,0,0,0
2022-03-03 11:30,91,57,34,0,0,0
2022-03-03 11:45,105,59,46,0,0,0
2022-03-03 12:00,79,37,42,0,0,0
2022-03-03 12:15,107,54,53,0,0,0
2022-03-03 12:30,115,75,40,0,0,0
2022-03-03 12:45,119,68,51,0,0,0
2022-03-03 13:00,122,61,61,0,0,0
2022-03-03 13:15,115,56,59,0,0,0
2022-03-03 13:30,102,49,53,0,0,0
2022-03-03 13:45,136,74,62,0,0,0
2022-03-03 14:00,128,60,68,0,0,0
2022-03-03 14:15,165,98,67,0,0,0
2022-03-03 14:30,140,92,48,0,0,0
2022-03-03 14:45,161,81,80,0,0,0
2022-03-03 15:00,136,77,59,0,0,0
2022-03-03 15:15,142,83,59,0,0,0
2022-03-03 15:30,156,88,68,0,0,0
2022-03-03 15:45,171,91,80,0,0,0
2022-03-03 16:00,170,87,83,0,0,0
2022-03-03 16:15,157,85,72,0,0,0
2022-03-03 16:30,174,100,74,0,0,0
2022-03-03 16:45,137,58,79,0,0,0
2022-03-03 17:00,150,87,63,0,0,0
2022-03-03 17:15,141,69,72,0,0,0
2022-03-03 17:30,139,71,68,0,0,0
2022-03-03 17:45,147,79,68,0,0,0
2022-03-03 18:00,141,57,84,0,0,0
2022-03-03 18:15,145,78,67,0,0,0
2022-03-03 18:30,103,54,49,0,0,0
2022-03-03 18:45,118,66,52,0,0,0
2022-03-03 19:00,95,46,49,0,0,0
2022-03-03 19:15,83,37,46,0,0,0
2022-03-03 19:30,80,45,35,0,0,0
2022-03-03 19:45,64,30,34,0,0,0
2022-03-03 20:00,57,24,33,0,0,0
2022-03-03 20:15,67,22,45,0,0,0
2022-03-03 20:30,41,22,19,0,0,0
2022-03-03 20:45,45,15,30,0,0,0
2022-03-03 21:00,46,13,33,0,0,0
2022-03-03 21:15,52,24,28,0,0,0
2022-03-03 21:30,37,16,21,0,0,0
2022-03-03 21:45,33,14,19,0,0,0
2022-03-03 22:00,47,17,30,0,0,0
2022-03-03 22:15,36,15,21,0,0,0
2022-03-03 22:30,25,11,14,0,0,0
2022-03-03 22:45,33,15,18,0,0,0
2022-03-03 23:00,14,7,7,0,0,0
2022-03-03 23:15,12,6,6,0,0,0
2022-03-03 23:30,15,8,7,0,0,0
2022-03-03 23:45,13,8,5,0,0,0
2022-03-04 00:00,15,6,9,0,0,0
2022-03-04 00:15,10,3,7,0,0,0
2022-03-04 00:30,15,6,9,0,0,0
2022-03-04 00:45,4,3,1,0,0,0
2022-03-04 01:00,2,0,2,0,0,0
2022-03-04 01:15,4,0,4,0,0,0
2022-03-04 01:30,2,1,1,0,0,0
2022-03-04 01:45,2,0,2,0,0,0
2022-03-04 02:00,2,0,2,0,0,0
2022-03-04 02:15,0,0,0,0,0,0
2022-03-04 02:30,3,1,2,0,0,0
2022-03-04 02:45,1,0,1,0,0,0
2022-03-04 03:00,0,0,0,0,0,0
2022-03-04 03:15,0,0,0,0,0,0
2022-03-04 03:30,0,0,0,0,0,0
2022-03-04 03:45,4,3,1,0,0,0
2022-03-04 04:00,1,1,0,0,0,0
2022-03-04 04:15,2,2,0,0,0,0
2022-03-04 04:30,0,0,0,0,0,0
2022-03-04 04:45,2,1,1,0,0,0
2022-03-04 05:00,1,1,0,0,0,0
2022-03-04 05:15,2,2,0,0,0,0
2022-03-04 05:30,12,7,5,0,0,0
2022-03-04 05:45,8,3,5,0,0,0
2022-03-04 06:00,14,8,6,0,0,0
2022-03-04 06:15,18,13,5,0,0,0
2022-03-04 06:30,48,25,23,0,0,0
2022-03-04 06:45,58,35,23,0,0,0
2022-03-04 07:00,69,49,20,0,0,0
2022-03-04 07:15,144,108,36,0,0,0
2022-03-04 07:30,316,268,48,0,0,0
2022-03-04 07:45,162,106,56,0,0,0
2022-03-04 08:00,128,105,23,0,0,0
2022-03-04 08:15,135,103,32,0,0,0
2022-03-04 08:30,107,77,30,0,0,0
2022-03-04 08:45,121,90,31,0,0,0
2022-03-04 09:00,82,54,28,0,0,0
2022-03-04 09:15,82,60,22,0,0,0
2022-03-04 09:30,100,74,26,0,0,0
2022-03-04 09:45,94,63,31,0,0,0
2022-03-04 10:00,62,44,18,0,0,0
2022-03-04 10:15,89,73,16,0,0,0
2022-03-04 10:30,80,57,23,0,0,0
2022-03-04 10:45,104,71,33,0,0,0
2022-03-04 11:00,92,58,34,0,0,0
2022-03-04 11:15,85,48,37,0,0,0
2022-03-04 11:30,125,67,58,0,0,0
2022-03-04 11:45,117,78,39,0,0,0
2022-03-04 12:00,96,55,41,0,0,0
2022-03-04 12:15,91,58,33,0,0,0
2022-03-04 12:30,124,69,55,0,0,0
2022-03-04 12:45,130,69,61,0,0,0
2022-03-04 13:00,154,63,91,0,0,0
2022-03-04 13:15,147,52,95,0,0,0
2022-03-04 13:30,121,56,65,0,0,0
2022-03-04 13:45,147,84,63,0,0,0
2022-03-04 14:00,175,79,96,0,0,0
2022-03-04 14:15,133,83,50,0,0,0
2022-03-04 14:30,137,78,59,0,0,0
2022-03-04 14:45,170,95,75,0,0,0
2022-03-04 15:00,126,57,69,0,0,0
2022-03-04 15:15,146,84,62,0,0,0
2022-03-04 15:30,156,95,61,0,0,0
2022-03-04 15:45,124,64,60,0,0,0
2022-03-04 16:00,122,65,57,0,0,0
2022-03-04 16:15,154,88,66,0,0,0
2022-03-04 16:30,137,75,62,0,0,0
2022-03-04 16:45,105,60,45,0,0,0
2022-03-04 17:00,102,60,42,0,0,0
2022-03-04 17:15,97,49,48,0,0,0
2022-03-04 17:30,111,59,52,0,0,0
2022-03-04 17:45,128,68,60,0,0,0
2022-03-04 18:00,113,59,54,0,0,0
2022-03-04 18:15,105,45,60,0,0,0
2022-03-04 18:30,89,49,40,0,0,0
2022-03-04 18:45,117,62,55,0,0,0
2022-03-04 19:00,72,38,34,0,0,0
2022-03-04 19:15,98,57,41,0,0,0
2022-03-04 19:30,73,40,33,0,0,0
2022-03-04 19:45,60,33,27,0,0,0
2022-03-04 20:00,56,28,28,0,0,0
2022-03-04 20:15,62,33,29,0,0,0
2022-03-04 20:30,44,26,18,0,0,0
2022-03-04 20:45,35,24,11,0,0,0
2022-03-04 21:00,58,34,24,0,0,0
2022-03-04 21:15,37,20,17,0,0,0
2022-03-04 21:30,46,27,19,0,0,0
2022-03-04 21:45,44,19,25,0,0,0
2022-03-04 22:00,35,14,21,0,0,0
2022-03-04 22:15,36,17,19,0,0,0
2022-03-04 22:30,35,13,22,0,0,0
2022-03-04 22:45,18,5,13,0,0,0
2022-03-04 23:00,34,19,15,0,0,0
2022-03-04 23:15,23,7,16,0,0,0
2022-03-04 23:30,26,11,15,0,0,0
2022-03-04 23:45,28,18,10,0,0,0
2022-03-05 00:00,30,12,18,0,0,0
2022-03-05 00:15,20,12,8,0,0,0
2022-03-05 00:30,19,5,14,0,0,0
2022-03-05 00:45,23,16,7,0,0,0
2022-03-05 01:00,22,7,15,0,0,0
2022-03-05 01:15,19,9,10,0,0,0
2022-03-05 01:30,13,5,8,0,0,0
2022-03-05 01:45,17,9,8,0,0,0
2022-03-05 02:00,11,3,8,0,0,0
2022-03-05 02:15,19,8,11,0,0,0
2022-03-05 02:30,12,5,7,0,0,0
2022-03-05 02:45,6,1,5,0,0,0
2022-03-05 03:00,9,2,7,0,0,0
2022-03-05 03:15,5,2,3,0,0,0
2022-03-05 03:30,7,1,6,0,0,0
2022-03-05 03:45,8,3,5,0,0,0
2022-03-05 04:00,2,1,1,0,0,0
2022-03-05 04:15,8,3,5,0,0,0
2022-03-05 04:30,9,2,7,0,0,0
2022-03-05 04:45,2,0,2,0,0,0
2022-03-05 05:00,1,1,0,0,0,0
2022-03-05 05:15,5,4,1,0,0,0
2022-03-05 05:30,5,3,2,0,0,0
2022-03-05 05:45,11,5,6,0,0,0
2022-03-05 06:00,8,5,3,0,0,0
2022-03-05 06:15,3,3,0,0,0,0
2022-03-05 06:30,4,3,1,0,0,0
2022-03-05 06:45,16,11,5,0,0,0
2022-03-05 07:00,9,6,3,0,0,0
2022-03-05 07:15,19,11,8,0,0,0
2022-03-05 07:30,20,13,7,0,0,0
2022-03-05 07:45,19,13,6,0,0,0
2022-03-05 08:00,22,17,5,0,0,0
2022-03-05 08:15,26,19,7,0,0,0
2022-03-05 08:30,32,23,9,0,0,0
2022-03-05 08:45,48,37,11,0,0,0
2022-03-05 09:00,57,44,13,0,0,0
2022-03-05 09:15,65,48,17,0,0,0
2022-03-05 09:30,57,43,14,0,0,0
2022-03-05 09:45,120,99,21,0,0,0
2022-03-05 10:00,96,67,29,0,0,0
2022-03-05 10:15,109,78,31,0,0,0
2022-03-05 10:30,113,93,20,0,0,0
2022-03-05 10:45,132,99,33,0,0,0
2022-03-05 11:00,161,120,41,0,0,0
2022-03-05 11:15,121,81,40,0,0,0
2022-03-05 11:30,121,80,41,0,0,0
2022-03-05 11:45,143,107,36,0,0,0
2022-03-05 12:00,142,95,47,0,0,0
2022-03-05 12:15,135,87,48,0,0,0
2022-03-05 12:30,143,87,56,0,0,0
2022-03-05 12:45,150,81,69,0,0,0
2022-03-05 13:00,145,89,56,0,0,0
2022-03-05 13:15,155,103,52,0,0,0
2022-03-05 13:30,113,64,49,0,0,0
2022-03-05 13:45,156,98,58,0,0,0
2022-03-05 14:00,156,87,69,0,0,0
2022-03-05 14:15,125,54,71,0,0,0
2022-03-05 14:30,133,60,73,0,0,0
2022-03-05 14:45,138,73,65,0,0,0
2022-03-05 15:00,157,82,75,0,0,0
2022-03-05 15:15,127,63,64,0,0,0
2022-03-05 15:30,144,60,84,0,0,0
2022-03-05 15:45,99,47,52,0,0,0
2022-03-05 16:00,102,52,50,0,0,0
2022-03-05 16:15,113,58,55,0,0,0
2022-03-05 16:30,99,43,56,0,0,0
2022-03-05 16:45,83,39,44,0,0,0
2022-03-05 17:00,101,51,50,0,0,0
2022-03-05 17:15,106,62,44,0,0,0
2022-03-05 17:30,93,49,44,0,0,0
2022-03-05 17:45,103,58,45,0,0,0
2022-03-05 18:00,68,27,41,0,0,0
2022-03-05 18:15,90,46,44,0,0,0
2022-03-05 18:30,74,36,38,0,0,0
2022-03-05 18:45,71,38,33,0,0,0
2022-03-05 19:00,66,42,24,0,0,0
2022-03-05 19:15,55,31,24,0,0,0
2022-03-05 19:30,42,28,14,0,0,0
2022-03-05 19:45,55,31,24,0,0,0
2022-03-05 20:00,62,27,35,0,0,0
2022-03-05 20:15,56,31,25,0,0,0
2022-03-05 20:30,35,22,13,0,0,0
2022-03-05 20:45,31,11,20,0,0,0
2022-03-05 21:00,27,16,11,0,0,0
2022-03-05 21:15,34,18,16,0,0,0
2022-03-05 21:30,25,19,6,0,0,0
2022-03-05 21:45,27,14,13,0,0,0
2022-03-05 22:00,22,10,12,0,0,0
2022-03-05 22:15,50,16,34,0,0,0
2022-03-05 22:30,28,16,12,0,0,0
2022-03-05 22:45,15,5,10,0,0,0
2022-03-05 23:00,21,12,9,0,0,0
2022-03-05 23:15,28,10,18,0,0,0
2022-03-05 23:30,17,6,11,0,0,0
2022-03-05 23:45,27,10,17,0,0,0
2022-03-06 00:00,23,6,17,0,0,0
2022-03-06 00:15,10,7,3,0,0,0
2022-03-06 00:30,26,7,19,0,0,0
2022-03-06 00:45,11,2,9,0,0,0
2022-03-06 01:00,19,5,14,0,0,0
2022-03-06 01:15,20,11,9,0,0,0
2022-03-06 01:30,13,2,11,0,0,0
2022-03-06 01:45,19,8,11,0,0,0
2022-03-06 02:00,16,8,8,0,0,0
2022-03-06 02:15,15,3,12,0,0,0
2022-03-06 02:30,5,0,5,0,0,0
2022-03-06 02:45,2,0,2,0,0,0
2022-03-06 03:00,6,3,3,0,0,0
2022-03-06 03:15,2,2,0,0,0,0
2022-03-06 03:30,7,3,4,0,0,0
2022-03-06 03:45,2,0,2,0,0,0
2022-03-06 04:00,1,1,0,0,0,0
2022-03-06 04:15,2,0,2,0,0,0
2022-03-06 04:30,5,2,3,0,0,0
2022-03-06 04:45,4,1,3,0,0,0
2022-03-06 05:00,2,1,1,0,0,0
2022-03-06 05:15,2,1,1,0,0,0
2022-03-06 05:30,4,3,1,0,0,0
2022-03-06 05:45,9,2,7,0,0,0
2022-03-06 06:00,7,4,3,0,0,0
2022-03-06 06:15,5,3,2,0,0,0
2022-03-06 06:30,1,1,0,0,0,0
2022-03-06 06:45,5,5,0,0,0,0
2022-03-06 07:00,6,3,3,0,0,0
2022-03-06 07:15,2,2,0,0,0,0
2022-03-06 07:30,8,3,5,0,0,0
2022-03-06 07:45,6,4,2,0,0,0
2022-03-06 08:00,14,8,6,0,0,0
2022-03-06 08:15,12,4,8,0,0,0
2022-03-06 08:30,4,3,1,0,0,0
2022-03-06 08:45,22,16,6,0,0,0
2022-03-06 09:00,22,18,4,0,0,0
2022-03-06 09:15,29,23,6,0,0,0
2022-03-06 09:30,26,21,5,0,0,0
2022-03-06 09:45,40,26,14,0,0,0
2022-03-06 10:00,41,30,11,0,0,0
2022-03-06 10:15,33,17,16,0,0,0
2022-03-06 10:30,22,14,8,0,0,0
2022-03-06 10:45,50,39,11,0,0,0
2022-03-06 11:00,35,21,14,0,0,0
2022-03-06 11:15,50,24,26,0,0,0
2022-03-06 11:30,28,21,7,0,0,0
2022-03-06 11:45,37,24,13,0,0,0
2022-03-06 12:00,58,35,23,0,0,0
2022-03-06 12:15,60,43,17,0,0,0
2022-03-06 12:30,54,33,21,0,0,0
2022-03-06 12:45,59,32,27,0,0,0
2022-03-06 13:00,54,35,19,0,0,0
2022-03-06 13:15,46,28,18,0,0,0
2022-03-06 13:30,59,35,24,0,0,0
2022-03-06 13:45,81,51,30,0,0,0
2022-03-06 14:00,81,49,32,0,0,0
2022-03-06 14:15,76,34,42,0,0,0
2022-03-06 14:30,82,47,35,0,0,0
2022-03-06 14:45,86,53,33,0,0,0
2022-03-06 15:00,60,41,19,0,0,0
2022-03-06 15:15,63,36,27,0,0,0
2022-03-06 15:30,56,34,22,0,0,0
2022-03-06 15:45,67,38,29,0,0,0
2022-03-06 16:00,40,30,10,0,0,0
2022-03-06 16:15,46,23,23,0,0,0
2022-03-06 16:30,55,30,25,0,0,0
2022-03-06 16:45,51,30,21,0,0,0
2022-03-06 17:00,56,35,21,0,0,0
2022-03-06 17:15,43,27,16,0,0,0
2022-03-06 17:30,60,38,22,0,0,0
2022-03-06 17:45,53,31,22,0,0,0
2022-03-06 18:00,56,32,24,0,0,0
2022-03-06 18:15,31,20,11,0,0,0
2022-03-06 18:30,48,26,22,0,0,0
2022-03-06 18:45,36,18,18,0,0,0
2022-03-06 19:00,36,18,18,0,0,0
2022-03-06 19:15,28,14,14,0,0,0
2022-03-06 19:30,35,14,21,0,0,0
2022-03-06 19:45,36,17,19,0,0,0
2022-03-06 20:00,24,13,11,0,0,0
2022-03-06 20:15,32,10,22,0,0,0
2022-03-06 20:30,39,14,25,0,0,0
2022-03-06 20:45,18,8,10,0,0,0
2022-03-06 21:00,21,9,12,0,0,0
2022-03-06 21:15,17,9,8,0,0,0
2022-03-06 21:30,19,8,11,0,0,0
2022-03-06 21:45,15,6,9,0,0,0
2022-03-06 22:00,16,4,12,0,0,0
2022-03-06 22:15,11,2,9,0,0,0
2022-03-06 22:30,9,4,5,0,0,0
2022-03-06 22:45,13,7,6,0,0,0
2022-03-06 23:00,4,4,0,0,0,0
2022-03-06 23:15,3,1,2,0,0,0
2022-03-06 23:30,7,3,4,0,0,0
2022-03-06 23:45,11,8,3,0,0,0
2022-03-07 00:00,2,1,1,0,0,0
2022-03-07 00:15,0,0,0,0,0,0
2022-03-07 00:30,3,2,1,0,0,0
2022-03-07 00:45,2,2,0,0,0,0
2022-03-07 01:00,3,1,2,0,0,0
2022-03-07 01:15,1,0,1,0,0,0
2022-03-07 01:30,1,1,0,0,0,0
2022-03-07 01:45,0,0,0,0,0,0
2022-03-07 02:00,0,0,0,0,0,0
2022-03-07 02:15,0,0,0,0,0,0
2022-03-07 02:30,0,0,0,0,0,0
2022-03-07 02:45,2,2,0,0,0,0
2022-03-07 03:00,0,0,0,0,0,0
2022-03-07 03:15,0,0,0,0,0,0
2022-03-07 03:30,0,0,0,0,0,0
2022-03-07 03:45,0,0,0,0,0,0
2022-03-07 04:00,2,2,0,0,0,0
2022-03-07 04:15,3,2,1,0,0,0
2022-03-07 04:30,0,0,0,0,0,0
2022-03-07 04:45,0,0,0,0,0,0
2022-03-07 05:00,3,3,0,0,0,0
2022-03-07 05:15,1,1,0,0,0,0
2022-03-07 05:30,14,9,5,0,0,0
2022-03-07 05:45,14,10,4,0,0,0
2022-03-07 06:00,20,15,5,0,0,0
2022-03-07 06:15,22,17,5,0,0,0
2022-03-07 06:30,34,22,12,0,0,0
2022-03-07 06:45,55,36,19,0,0,0
2022-03-07 07:00,89,62,27,0,0,0
2022-03-07 07:15,164,125,39,0,0,0
2022-03-07 07:30,306,243,63,0,0,0
2022-03-07 07:45,180,115,65,0,0,0
2022-03-07 08:00,128,104,24,0,0,0
2022-03-07 08:15,141,102,39,0,0,0
2022-03-07 08:30,137,108,29,0,0,0
2022-03-07 08:45,134,96,38,0,0,0
2022-03-07 09:00,89,61,28,0,0,0
2022-03-07 09:15,99,71,28,0,0,0
2022-03-07 09:30,70,48,22,0,0,0
2022-03-07 09:45,77,51,26,0,0,0
2022-03-07 10:00,60,45,15,0,0,0
2022-03-07 10:15,83,65,18,0,0,0
2022-03-07 10:30,90,69,21,0,0,0
2022-03-07 10:45,95,62,33,0,0,0
2022-03-07 11:00,62,39,23,0,0,0
2022-03-07 11:15,114,64,50,0,0,0
2022-03-07 11:30,104,54,50,0,0,0
2022-03-07 11:45,102,57,45,0,0,0
2022-03-07 12:00,89,55,34,0,0,0
2022-03-07 12:15,102,61,41,0,0,0
2022-03-07 12:30,122,59,63,0,0,0
2022-03-07 12:45,98,46,52,0,0,0
2022-03-07 13:00,111,59,52,0,0,0
2022-03-07 13:15,105,56,49,0,0,0
2022-03-07 13:30,90,54,36,0,0,0
2022-03-07 13:45,113,65,48,0,0,0
2022-03-07 14:00,114,62,52,0,0,0
2022-03-07 14:15,111,53,58,0,0,0
2022-03-07 14:30,140,85,55,0,0,0
2022-03-07 14:45,136,80,56,0,0,0
2022-03-07 15:00,106,54,52,0,0,0
2022-03-07 15:15,122,64,58,0,0,0
2022-03-07 15:30,140,75,65,0,0,0
2022-03-07 15:45,163,80,83,0,0,0
2022-03-07 16:00,162,96,66,0,0,0
2022-03-07 16:15,163,81,82,0,0,0
2022-03-07 16:30,146,87,59,0,0,0
2022-03-07 16:45,158,87,71,0,0,0
2022-03-07 17:00,124,61,63,0,0,0
2022-03-07 17:15,141,67,74,0,0,0
2022-03-07 17:30,136,67,69,0,0,0
2022-03-07 17:45,179,90,89,0,0,0
2022-03-07 18:00,130,62,68,0,0,0
2022-03-07 18:15,129,71,58,0,0,0
2022-03-07 18:30,79,26,53,0,0,0
2022-03-07 18:45,106,44,62,0,0,0
2022-03-07 19:00,80,25,55,0,0,0
2022-03-07 19:15,64,30,34,0,0,0
2022-03-07 19:30,72,34,38,0,0,0
2022-03-07 19:45,60,28,32,0,0,0
2022-03-07 20:00,53,26,27,0,0,0
2022-03-07 20:15,46,17,29,0,0,0
2022-03-07 20:30,48,20,28,0,0,0
2022-03-07 20:45,31,13,18,0,0,0
2022-03-07 21:00,23,14,9,0,0,0
2022-03-07 21:15,33,16,17,0,0,0
2022-03-07 21:30,38,12,26,0,0,0
2022-03-07 21:45,38,15,23,0,0,0
2022-03-07 22:00,18,14,4,0,0,0
2022-03-07 22:15,26,11,15,0,0,0
2022-03-07 22:30,14,5,9,0,0,0
2022-03-07 22:45,16,4,12,0,0,0
2022-03-07 23:00,12,9,3,0,0,0
2022-03-07 23:15,9,3,6,0,0,0
2022-03-07 23:30,6,3,3,0,0,0
2022-03-07 23:45,4,1,3,0,0,0
2022-03-08 00:00,4,0,4,0,0,0
2022-03-08 00:15,10,2,8,0,0,0
2022-03-08 00:30,6,2,4,0,0,0
2022-03-08 00:45,4,2,2,0,0,0
2022-03-08 01:00,2,0,2,0,0,0
2022-03-08 01:15,1,0,1,0,0,0
2022-03-08 01:30,1,1,0,0,0,0
2022-03-08 01:45,0,0,0,0,0,0
2022-03-08 02:00,0,0,0,0,0,0
2022-03-08 02:15,0,0,0,0,0,0
2022-03-08 02:30,0,0,0,0,0,0
2022-03-08 02:45,0,0,0,0,0,0
2022-03-08 03:00,5,3,2,0,0,0
2022-03-08 03:15,1,0,1,0,0,0
2022-03-08 03:30,0,0,0,0,0,0
2022-03-08 03:45,0,0,0,0,0,0
2022-03-08 04:00,0,0,0,0,0,0
2022-03-08 04:15,3,2,1,0,0,0
2022-03-08 04:30,0,0,0,0,0,0
2022-03-08 04:45,1,0,1,0,0,0
2022-03-08 05:00,2,1,1,0,0,0
2022-03-08 05:15,6,5,1,0,0,0
2022-03-08 05:30,10,8,2,0,0,0
2022-03-08 05:45,28,14,14,0,0,0
2022-03-08 06:00,12,10,2,0,0,0
2022-03-08 06:15,35,18,17,0,0,0
2022-03-08 06:30,47,27,20,0,0,0
2022-03-08 06:45,57,40,17,0,0,0
2022-03-08 07:00,92,67,25,0,0,0
2022-03-08 07:15,165,129,36,0,0,0
2022-03-08 07:30,307,262,45,0,0,0
2022-03-08 07:45,208,143,65,0,0,0
2022-03-08 08:00,136,98,38,0,0,0
2022-03-08 08:15,166,126,40,0,0,0
2022-03-08 08:30,133,100,33,0,0,0
2022-03-08 08:45,119,83,36,0,0,0
2022-03-08 09:00,85,54,31,0,0,0
2022-03-08 09:15,87,60,27,0,0,0
2022-03-08 09:30,99,69,30,0,0,0
2022-03-08 09:45,111,86,25,0,0,0
2022-03-08 10:00,68,51,17,0,0,0
2022-03-08 10:15,100,68,32,0,0,0
2022-03-08 10:30,81,53,28,0,0,0
2022-03-08 10:45,124,84,40,0,0,0
2022-03-08 11:00,82,46,36,0,0,0
2022-03-08 11:15,94,56,38,0,0,0
2022-03-08 11:30,101,55,46,0,0,0
2022-03-08 11:45,103,58,45,0,0,0
2022-03-08 12:00,101,60,41,0,0,0
2022-03-08 12:15,96,56,40,0,0,0
2022-03-08 12:30,117,64,53,0,0,0
2022-03-08 12:45,95,58,37,0,0,0
2022-03-08 13:00,146,69,77,0,0,0
2022-03-08 13:15,142,76,66,0,0,0
2022-03-08 13:30,115,63,52,0,0,0
2022-03-08 13:45,110,62,48,0,0,0
2022-03-08 14:00,131,64,67,0,0,0
2022-03-08 14:15,118,57,61,0,0,0
2022-03-08 14:30,134,69,65,0,0,0
2022-03-08 14:45,148,87,61,0,0,0
2022-03-08 15:00,145,60,85,0,0,0
2022-03-08 15:15,137,78,59,0,0,0
2022-03-08 15:30,155,79,76,0,0,0
2022-03-08 15:45,189,127,62,0,0,0
2022-03-08 16:00,156,80,76,0,0,0
2022-03-08 16:15,189,96,93,0,0,0
2022-03-08 16:30,162,86,76,0,0,0
2022-03-08 16:45,179,99,80,0,0,0
2022-03-08 17:00,153,83,70,0,0,0
2022-03-08 17:15,172,79,93,0,0,0
2022-03-08 17:30,169,100,69,0,0,0
2022-03-08 17:45,183,70,113,0,0,0
2022-03-08 18:00,167,73,94,0,0,0
2022-03-08 18:15,121,60,61,0,0,0
2022-03-08 18:30,98,37,61,0,0,0
2022-03-08 18:45,108,49,59,0,0,0
2022-03-08 19:00,100,43,57,0,0,0
2022-03-08 19:15,84,33,51,0,0,0
2022-03-08 19:30,73,28,45,0,0,0
2022-03-08 19:45,66,26,40,0,0,0
2022-03-08 20:00,64,33,31,0,0,0
2022-03-08 20:15,56,27,29,0,0,0
2022-03-08 20:30,46,20,26,0,0,0
2022-03-08 20:45,38,19,19,0,0,0
2022-03-08 21:00,37,14,23,0,0,0
2022-03-08 21:15,29,15,14,0,0,0
2022-03-08 21:30,27,10,17,0,0,0
2022-03-08 21:45,34,9,25,0,0,0
2022-03-08 22:00,42,20,22,0,0,0
2022-03-08 22:15,32,18,14,0,0,0
2022-03-08 22:30,23,11,12,0,0,0
2022-03-08 22:45,23,14,9,0,0,0
2022-03-08 23:00,22,9,13,0,0,0
2022-03-08 23:15,13,5,8,0,0,0
2022-03-08 23:30,15,6,9,0,0,0
2022-03-08 23:45,10,5,5,0,0,0
2022-03-09 00:00,5,3,2,0,0,0
2022-03-09 00:15,3,3,0,0,0,0
2022-03-09 00:30,2,0,2,0,0,0
2022-03-09 00:45,5,0,5,0,0,0
2022-03-09 01:00,2,2,0,0,0,0
2022-03-09 01:15,1,0,1,0,0,0
2022-03-09 01:30,1,1,0,0,0,0
2022-03-09 01:45,2,1,1,0,0,0
2022-03-09 02:00,1,0,1,0,0,0
2022-03-09 02:15,2,0,2,0,0,0
2022-03-09 02:30,2,0,2,0,0,0
2022-03-09 02:45,2,2,0,0,0,0
2022-03-09 03:00,0,0,0,0,0,0
2022-03-09 03:15,0,0,0,0,0,0
2022-03-09 03:30,0,0,0,0,0,0
2022-03-09 03:45,1,1,0,0,0,0
2022-03-09 04:00,0,0,0,0,0,0
2022-03-09 04:15,4,4,0,0,0,0
2022-03-09 04:30,3,3,0,0,0,0
2022-03-09 04:45,3,2,1,0,0,0
2022-03-09 05:00,2,2,0,0,0,0
2022-03-09 05:15,1,0,1,0,0,0
2022-03-09 05:30,5,2,3,0,0,0
2022-03-09 05:45,16,10,6,0,0,0
2022-03-09 06:00,15,11,4,0,0,0
2022-03-09 06:15,23,17,6,0,0,0
2022-03-09 06:30,46,29,17,0,0,0
2022-03-09 06:45,62,45,17,0,0,0
2022-03-09 07:00,99,73,26,0,0,0
2022-03-09 07:15,178,131,47,0,0,0
2022-03-09 07:30,294,242,52,0,0,0
2022-03-09 07:45,213,143,70,0,0,0
2022-03-09 08:00,150,118,32,0,0,0
2022-03-09 08:15,146,104,42,0,0,0
2022-03-09 08:30,155,125,30,0,0,0
2022-03-09 08:45,150,118,32,0,0,0
2022-03-09 09:00,112,85,27,0,0,0
2022-03-09 09:15,110,77,33,0,0,0
2022-03-09 09:30,115,93,22,0,0,0
2022-03-09 09:45,124,97,27,0,0,0
2022-03-09 10:00,105,73,32,0,0,0
2022-03-09 10:15,121,95,26,0,0,0
2022-03-09 10:30,111,81,30,0,0,0
2022-03-09 10:45,112,69,43,0,0,0
2022-03-09 11:00,133,89,44,0,0,0
2022-03-09 11:15,105,73,32,0,0,0
2022-03-09 11:30,110,72,38,0,0,0
2022-03-09 11:45,132,74,58,0,0,0
2022-03-09 12:00,147,89,58,0,0,0
2022-03-09 12:15,153,79,74,0,0,0
2022-03-09 12:30,147,67,80,0,0,0
2022-03-09 12:45,160,88,72,0,0,0
2022-03-09 13:00,136,75,61,0,0,0
2022-03-09 13:15,153,70,83,0,0,0
2022-03-09 13:30,126,68,58,0,0,0
2022-03-09 13:45,147,65,82,0,0,0
2022-03-09 14:00,164,72,92,0,0,0
2022-03-09 14:15,142,76,66,0,0,0
2022-03-09 14:30,119,61,58,0,0,0
2022-03-09 14:45,146,69,77,0,0,0
2022-03-09 15:00,149,77,72,0,0,0
2022-03-09 15:15,154,92,62,0,0,0
2022-03-09 15:30,137,76,61,0,0,0
2022-03-09 15:45,150,75,75,0,0,0
2022-03-09 16:00,161,77,84,0,0,0
2022-03-09 16:15,157,76,81,0,0,0
2022-03-09 16:30,179,100,79,0,0,0
2022-03-09 16:45,174,103,71,0,0,0
2022-03-09 17:00,164,87,77,0,0,0
2022-03-09 17:15,148,74,74,0,0,0
2022-03-09 17:30,160,81,79,0,0,0
2022-03-09 17:45,156,90,66,0,0,0
2022-03-09 18:00,146,76,70,0,0,0
2022-03-09 18:15,162,80,82,0,0,0
2022-03-09 18:30,109,47,62,0,0,0
2022-03-09 18:45,133,56,77,0,0,0
2022-03-09 19:00,83,35,48,0,0,0
2022-03-09 19:15,102,50,52,0,0,0
2022-03-09 19:30,67,31,36,0,0,0
2022-03-09 19:45,70,26,44,0,0,0
2022-03-09 20:00,58,23,35,0,0,0
2022-03-09 20:15,52,15,37,0,0,0
2022-03-09 20:30,50,25,25,0,0,0
2022-03-09 20:45,47,23,24,0,0,0
2022-03-09 21:00,53,23,30,0,0,0
2022-03-09 21:15,38,14,24,0,0,0
2022-03-09 21:30,48,17,31,0,0,0
2022-03-09 21:45,26,13,13,0,0,0
2022-03-09 22:00,35,20,15,0,0,0
2022-03-09 22:15,22,7,15,0,0,0
2022-03-09 22:30,34,18,16,0,0,0
2022-03-09 22:45,33,14,19,0,0,0
2022-03-09 23:00,23,8,15,0,0,0
2022-03-09 23:15,19,11,8,0,0,0
2022-03-09 23:30,13,7,6,0,0,0
2022-03-09 23:45,25,9,16,0,0,0
2022-03-10 00:00,14,6,8,0,0,0
2022-03-10 00:15,14,8,6,0,0,0
2022-03-10 00:30,7,1,6,0,0,0
2022-03-10 00:45,4,2,2,0,0,0
2022-03-10 01:00,1,1,0,0,0,0
2022-03-10 01:15,4,0,4,0,0,0
2022-03-10 01:30,1,1,0,0,0,0
2022-03-10 01:45,4,0,4,0,0,0
2022-03-10 02:00,2,0,2,0,0,0
2022-03-10 02:15,3,1,2,0,0,0
2022-03-10 02:30,3,0,3,0,0,0
2022-03-10 02:45,1,0,1,0,0,0
2022-03-10 03:00,3,2,1,0,0,0
2022-03-10 03:15,1,1,0,0,0,0
2022-03-10 03:30,1,0,1,0,0,0
2022-03-10 03:45,0,0,0,0,0,0
2022-03-10 04:00,1,1,0,0,0,0
2022-03-10 04:15,3,2,1,0,0,0
2022-03-10 04:30,0,0,0,0,0,0
2022-03-10 04:45,2,0,2,0,0,0
2022-03-10 05:00,1,1,0,0,0,0
2022-03-10 05:15,0,0,0,0,0,0
2022-03-10 05:30,11,8,3,0,0,0
2022-03-10 05:45,15,7,8,0,0,0
2022-03-10 06:00,22,12,10,0,0,0
2022-03-10 06:15,26,19,7,0,0,0
2022-03-10 06:30,38,24,14,0,0,0
2022-03-10 06:45,57,33,24,0,0,0
2022-03-10 07:00,96,68,28,0,0,0
2022-03-10 07:15,171,133,38,0,0,0
2022-03-10 07:30,319,273,46,0,0,0
2022-03-10 07:45,202,124,78,0,0,0
2022-03-10 08:00,146,112,34,0,0,0
2022-03-10 08:15,143,101,42,0,0,0
2022-03-10 08:30,137,113,24,0,0,0
2022-03-10 08:45,148,112,36,0,0,0
2022-03-10 09:00,111,87,24,0,0,0
2022-03-10 09:15,108,85,23,0,0,0
2022-03-10 09:30,81,54,27,0,0,0
2022-03-10 09:45,110,84,26,0,0,0
2022-03-10 10:00,64,47,17,0,0,0
2022-03-10 10:15,90,66,24,0,0,0
2022-03-10 10:30,95,66,29,0,0,0
2022-03-10 10:45,100,65,35,0,0,0
2022-03-10 11:00,84,56,28,0,0,0
2022-03-10 11:15,105,71,34,0,0,0
2022-03-10 11:30,111,70,41,0,0,0
2022-03-10 11:45,116,69,47,0,0,0
2022-03-10 12:00,110,58,52,0,0,0
2022-03-10 12:15,122,74,48,0,0,0
2022-03-10 12:30,121,64,57,0,0,0
2022-03-10 12:45,142,87,55,0,0,0
2022-03-10 13:00,125,61,64,0,0,0
2022-03-10 13:15,111,58,53,0,0,0
2022-03-10 13:30,133,65,68,0,0,0
2022-03-10 13:45,136,63,73,0,0,0
2022-03-10 14:00,140,71,69,0,0,0
2022-03-10 14:15,143,65,78,0,0,0
2022-03-10 14:30,127,69,58,0,0,0
2022-03-10 14:45,144,81,63,0,0,0
2022-03-10 15:00,164,84,80,0,0,0
2022-03-10 15:15,145,78,67,0,0,0
2022-03-10 15:30,165,77,88,0,0,0
2022-03-10 15:45,187,108,79,0,0,0
2022-03-10 16:00,180,89,91,0,0,0
2022-03-10 16:15,210,121,89,0,0,0
2022-03-10 16:30,172,92,80,0,0,0
2022-03-10 16:45,164,94,70,0,0,0
2022-03-10 17:00,146,79,67,0,0,0
2022-03-10 17:15,164,81,83,0,0,0
2022-03-10 17:30,176,101,75,0,0,0
2022-03-10 17:45,158,85,73,0,0,0
2022-03-10 18:00,165,78,87,0,0,0
2022-03-10 18:15,159,80,79,0,0,0
2022-03-10 18:30,132,64,68,0,0,0
2022-03-10 18:45,114,63,51,0,0,0
2022-03-10 19:00,109,45,64,0,0,0
2022-03-10 19:15,93,44,49,0,0,0
2022-03-10 19:30,82,39,43,0,0,0
2022-03-10 19:45,84,35,49,0,0,0
2022-03-10 20:00,62,26,36,0,0,0
2022-03-10 20:15,43,19,24,0,0,0
2022-03-10 20:30,49,22,27,0,0,0
2022-03-10 20:45,45,12,33,0,0,0
2022-03-10 21:00,35,11,24,0,0,0
2022-03-10 21:15,48,25,23,0,0,0
2022-03-10 21:30,36,14,22,0,0,0
2022-03-10 21:45,35,21,14,0,0,0
2022-03-10 22:00,51,18,33,0,0,0
2022-03-10 22:15,42,17,25,0,0,0
2022-03-10 22:30,32,11,21,0,0,0
2022-03-10 22:45,32,11,21,0,0,0
2022-03-10 23:00,18,6,12,0,0,0
2022-03-10 23:15,22,13,9,0,0,0
2022-03-10 23:30,12,8,4,0,0,0
2022-03-10 23:45,18,5,13,0,0,0
2022-03-11 00:00,16,10,6,0,0,0
2022-03-11 00:15,11,5,6,0,0,0
2022-03-11 00:30,5,2,3,0,0,0
2022-03-11 00:45,8,6,2,0,0,0
2022-03-11 01:00,4,0,4,0,0,0
2022-03-11 01:15,3,1,2,0,0,0
2022-03-11 01:30,2,1,1,0,0,0
2022-03-11 01:45,3,1,2,0,0,0
2022-03-11 02:00,3,0,3,0,0,0
2022-03-11 02:15,1,0,1,0,0,0
2022-03-11 02:30,3,0,3,0,0,0
2022-03-11 02:45,0,0,0,0,0,0
2022-03-11 03:00,1,0,1,0,0,0
2022-03-11 03:15,0,0,0,0,0,0
2022-03-11 03:30,2,2,0,0,0,0
2022-03-11 03:45,1,0,1,0,0,0
2022-03-11 04:00,1,1,0,0,0,0
2022-03-11 04:15,1,1,0,0,0,0
2022-03-11 04:30,1,1,0,0,0,0
2022-03-11 04:45,2,0,2,0,0,0
2022-03-11 05:00,1,1,0,0,0,0
2022-03-11 05:15,2,1,1,0,0,0
2022-03-11 05:30,10,6,4,0,0,0
2022-03-11 05:45,18,10,8,0,0,0
2022-03-11 06:00,18,11,7,0,0,0
2022-03-11 06:15,24,16,8,0,0,0
2022-03-11 06:30,33,18,15,0,0,0
2022-03-11 06:45,46,28,18,0,0,0
2022-03-11 07:00,88,65,23,0,0,0
2022-03-11 07:15,166,136,30,0,0,0
2022-03-11 07:30,302,251,51,0,0,0
2022-03-11 07:45,179,131,48,0,0,0
2022-03-11 08:00,133,108,25,0,0,0
2022-03-11 08:15,143,104,39,0,0,0
2022-03-11 08:30,131,100,31,0,0,0
2022-03-11 08:45,118,98,20,0,0,0
2022-03-11 09:00,85,66,19,0,0,0
2022-03-11 09:15,89,69,20,0,0,0
2022-03-11 09:30,88,62,26,0,0,0
2022-03-11 09:45,93,67,26,0,0,0
2022-03-11 10:00,88,63,25,0,0,0
2022-03-11 10:15,102,71,31,0,0,0
2022-03-11 10:30,78,49,29,0,0,0
2022-03-11 10:45,105,70,35,0,0,0
2022-03-11 11:00,87,57,30,0,0,0
2022-03-11 11:15,104,59,45,0,0,0
2022-03-11 11:30,96,66,30,0,0,0
2022-03-11 11:45,113,74,39,0,0,0
2022-03-11 12:00,113,68,45,0,0,0
2022-03-11 12:15,101,64,37,0,0,0
2022-03-11 12:30,128,75,53,0,0,0
2022-03-11 12:45,130,72,58,0,0,0
2022-03-11 13:00,177,91,86,0,0,0
2022-03-11 13:15,155,75,80,0,0,0
2022-03-11 13:30,126,61,65,0,0,0
2022-03-11 13:45,144,75,69,0,0,0
2022-03-11 14:00,146,73,73,0,0,0
2022-03-11 14:15,165,77,88,0,0,0
2022-03-11 14:30,156,76,80,0,0,0
2022-03-11 14:45,182,108,74,0,0,0
2022-03-11 15:00,144,74,70,0,0,0
2022-03-11 15:15,160,92,68,0,0,0
2022-03-11 15:30,144,71,73,0,0,0
2022-03-11 15:45,157,90,67,0,0,0
2022-03-11 16:00,135,73,62,0,0,0
2022-03-11 16:15,141,66,75,0,0,0
2022-03-11 16:30,143,73,70,0,0,0
2022-03-11 16:45,127,78,49,0,0,0
2022-03-11 17:00,145,77,68,0,0,0
2022-03-11 17:15,139,81,58,0,0,0
2022-03-11 17:30,128,73,55,0,0,0
2022-03-11 17:45,127,60,67,0,0,0
2022-03-11 18:00,128,51,77,0,0,0
2022-03-11 18:15,114,58,56,0,0,0
2022-03-11 18:30,105,52,53,0,0,0
2022-03-11 18:45,128,64,64,0,0,0
2022-03-11 19:00,106,59,47,0,0,0
2022-03-11 19:15,99,58,41,0,0,0
2022-03-11 19:30,74,37,37,0,0,0
2022-03-11 19:45,88,43,45,0,0,0
2022-03-11 20:00,73,38,35,0,0,0
2022-03-11 20:15,65,29,36,0,0,0
2022-03-11 20:30,46,27,19,0,0,0
2022-03-11 20:45,47,11,36,0,0,0
2022-03-11 21:00,44,23,21,0,0,0
2022-03-11 21:15,50,25,25,0,0,0
2022-03-11 21:30,46,24,22,0,0,0
2022-03-11 21:45,36,14,22,0,0,0
2022-03-11 22:00,52,15,37,0,0,0
2022-03-11 22:15,18,7,11,0,0,0
2022-03-11 22:30,39,24,15,0,0,0
2022-03-11 22:45,49,16,33,0,0,0
2022-03-11 23:00,24,9,15,0,0,0
2022-03-11 23:15,35,12,23,0,0,0
2022-03-11 23:30,51,30,21,0,0,0
2022-03-11 23:45,31,16,15,0,0,0
