Datetime,100034981 (Weseler Straße),101034981 (Weseler Straße stadteinwärts),102034981 (Weseler Straße stadtauswärts),100034981-status,101034981-status,102034981-status
2022-06-01 00:00,10,5,5,0,0,0
2022-06-01 00:15,3,2,1,0,0,0
2022-06-01 00:30,11,6,5,0,0,0
2022-06-01 00:45,5,3,2,0,0,0
2022-06-01 01:00,1,0,1,0,0,0
2022-06-01 01:15,4,1,3,0,0,0
2022-06-01 01:30,4,4,0,0,0,0
2022-06-01 01:45,1,0,1,0,0,0
2022-06-01 02:00,1,0,1,0,0,0
2022-06-01 02:15,1,0,1,0,0,0
2022-06-01 02:30,1,0,1,0,0,0
2022-06-01 02:45,4,1,3,0,0,0
2022-06-01 03:00,1,0,1,0,0,0
2022-06-01 03:15,1,1,0,0,0,0
2022-06-01 03:30,0,0,0,0,0,0
2022-06-01 03:45,0,0,0,0,0,0
2022-06-01 04:00,1,1,0,0,0,0
2022-06-01 04:15,0,0,0,0,0,0
2022-06-01 04:30,0,0,0,0,0,0
2022-06-01 04:45,7,4,3,0,0,0
2022-06-01 05:00,4,3,1,0,0,0
2022-06-01 05:15,8,6,2,0,0,0
2022-06-01 05:30,13,7,6,0,0,0
2022-06-01 05:45,12,8,4,0,0,0
2022-06-01 06:00,14,11,3,0,0,0
2022-06-01 06:15,22,15,7,0,0,0
2022-06-01 06:30,26,9,17,0,0,0
2022-06-01 06:45,45,28,17,0,0,0
2022-06-01 07:00,58,33,25,0,0,0
2022-06-01 07:15,106,68,38,0,0,0
2022-06-01 07:30,155,104,51,0,0,0
2022-06-01 07:45,122,66,56,0,0,0
2022-06-01 08:00,87,56,31,0,0,0
2022-06-01 08:15,87,45,42,0,0,0
2022-06-01 08:30,77,51,26,0,0,0
2022-06-01 08:45,79,51,28,0,0,0
2022-06-01 09:00,59,38,21,0,0,0
2022-06-01 09:15,58,43,15,0,0,0
2022-06-01 09:30,69,52,17,0,0,0
2022-06-01 09:45,77,62,15,0,0,0
2022-06-01 10:00,73,52,21,0,0,0
2022-06-01 10:15,45,36,9,0,0,0
2022-06-01 10:30,58,44,14,0,0,0
2022-06-01 10:45,39,22,17,0,0,0
2022-06-01 11:00,53,42,11,0,0,0
2022-06-01 11:15,34,24,10,0,0,0
2022-06-01 11:30,47,27,20,0,0,0
2022-06-01 11:45,73,55,18,0,0,0
2022-06-01 12:00,68,45,23,0,0,0
2022-06-01 12:15,54,46,8,0,0,0
2022-06-01 12:30,58,40,18,0,0,0
2022-06-01 12:45,85,48,37,0,0,0
2022-06-01 13:00,50,26,24,0,0,0
2022-06-01 13:15,59,28,31,0,0,0
2022-06-01 13:30,50,26,24,0,0,0
2022-06-01 13:45,81,47,34,0,0,0
2022-06-01 14:00,63,35,28,0,0,0
2022-06-01 14:15,51,30,21,0,0,0
2022-06-01 14:30,63,37,26,0,0,0
2022-06-01 14:45,59,29,30,0,0,0
2022-06-01 15:00,49,23,26,0,0,0
2022-06-01 15:15,25,13,12,0,0,0
2022-06-01 15:30,43,27,16,0,0,0
2022-06-01 15:45,79,55,24,0,0,0
2022-06-01 16:00,81,52,29,0,0,0
2022-06-01 16:15,80,49,31,0,0,0
2022-06-01 16:30,72,44,28,0,0,0
2022-06-01 16:45,92,77,15,0,0,0
2022-06-01 17:00,85,59,26,0,0,0
2022-06-01 17:15,67,49,18,0,0,0
2022-06-01 17:30,73,50,23,0,0,0
2022-06-01 17:45,90,59,31,0,0,0
2022-06-01 18:00,79,48,31,0,0,0
2022-06-01 18:15,51,43,8,0,0,0
2022-06-01 18:30,35,20,15,0,0,0
2022-06-01 18:45,57,39,18,0,0,0
2022-06-01 19:00,51,28,23,0,0,0
2022-06-01 19:15,50,26,24,0,0,0
2022-06-01 19:30,46,28,18,0,0,0
2022-06-01 19:45,48,28,20,0,0,0
2022-06-01 20:00,36,18,18,0,0,0
2022-06-01 20:15,28,18,10,0,0,0
2022-06-01 20:30,34,26,8,0,0,0
2022-06-01 20:45,28,16,12,0,0,0
2022-06-01 21:00,16,9,7,0,0,0
2022-06-01 21:15,24,14,10,0,0,0
2022-06-01 21:30,16,12,4,0,0,0
2022-06-01 21:45,27,17,10,0,0,0
2022-06-01 22:00,26,14,12,0,0,0
2022-06-01 22:15,17,7,10,0,0,0
2022-06-01 22:30,28,14,14,0,0,0
2022-06-01 22:45,21,5,16,0,0,0
2022-06-01 23:00,10,6,4,0,0,0
2022-06-01 23:15,9,4,5,0,0,0
2022-06-01 23:30,12,5,7,0,0,0
2022-06-01 23:45,7,4,3,0,0,0
2022-06-02 00:00,5,3,2,0,0,0
2022-06-02 00:15,7,1,6,0,0,0
2022-06-02 00:30,7,3,4,0,0,0
2022-06-02 00:45,2,0,2,0,0,0
2022-06-02 01:00,7,2,5,0,0,0
2022-06-02 01:15,3,1,2,0,0,0
2022-06-02 01:30,7,3,4,0,0,0
2022-06-02 01:45,6,1,5,0,0,0
2022-06-02 02:00,2,1,1,0,0,0
2022-06-02 02:15,3,1,2,0,0,0
2022-06-02 02:30,4,2,2,0,0,0
2022-06-02 02:45,4,1,3,0,0,0
2022-06-02 03:00,8,0,8,0,0,0
2022-06-02 03:15,3,3,0,0,0,0
2022-06-02 03:30,5,3,2,0,0,0
2022-06-02 03:45,2,0,2,0,0,0
2022-06-02 04:00,3,1,2,0,0,0
2022-06-02 04:15,1,0,1,0,0,0
2022-06-02 04:30,5,4,1,0,0,0
2022-06-02 04:45,4,4,0,0,0,0
2022-06-02 05:00,5,3,2,0,0,0
2022-06-02 05:15,7,4,3,0,0,0
2022-06-02 05:30,15,4,11,0,0,0
2022-06-02 05:45,7,4,3,0,0,0
2022-06-02 06:00,13,9,4,0,0,0
2022-06-02 06:15,23,17,6,0,0,0
2022-06-02 06:30,20,7,13,0,0,0
2022-06-02 06:45,41,17,24,0,0,0
2022-06-02 07:00,46,20,26,0,0,0
2022-06-02 07:15,61,43,18,0,0,0
2022-06-02 07:30,168,121,47,0,0,0
2022-06-02 07:45,113,57,56,0,0,0
2022-06-02 08:00,85,48,37,0,0,0
2022-06-02 08:15,102,63,39,0,0,0
2022-06-02 08:30,74,50,24,0,0,0
2022-06-02 08:45,76,52,24,0,0,0
2022-06-02 09:00,45,37,8,0,0,0
2022-06-02 09:15,54,45,9,0,0,0
2022-06-02 09:30,41,28,13,0,0,0
2022-06-02 09:45,64,47,17,0,0,0
2022-06-02 10:00,50,37,13,0,0,0
2022-06-02 10:15,43,33,10,0,0,0
2022-06-02 10:30,35,20,15,0,0,0
2022-06-02 10:45,38,23,15,0,0,0
2022-06-02 11:00,38,30,8,0,0,0
2022-06-02 11:15,44,31,13,0,0,0
2022-06-02 11:30,37,25,12,0,0,0
2022-06-02 11:45,58,42,16,0,0,0
2022-06-02 12:00,56,35,21,0,0,0
2022-06-02 12:15,61,35,26,0,0,0
2022-06-02 12:30,43,28,15,0,0,0
2022-06-02 12:45,44,31,13,0,0,0
2022-06-02 13:00,36,23,13,0,0,0
2022-06-02 13:15,63,35,28,0,0,0
2022-06-02 13:30,56,41,15,0,0,0
2022-06-02 13:45,95,63,32,0,0,0
2022-06-02 14:00,85,38,47,0,0,0
2022-06-02 14:15,63,33,30,0,0,0
2022-06-02 14:30,56,29,27,0,0,0
2022-06-02 14:45,67,42,25,0,0,0
2022-06-02 15:00,67,41,26,0,0,0
2022-06-02 15:15,75,53,22,0,0,0
2022-06-02 15:30,94,54,40,0,0,0
2022-06-02 15:45,91,54,37,0,0,0
2022-06-02 16:00,95,55,40,0,0,0
2022-06-02 16:15,87,53,34,0,0,0
2022-06-02 16:30,88,56,32,0,0,0
2022-06-02 16:45,100,63,37,0,0,0
2022-06-02 17:00,83,51,32,0,0,0
2022-06-02 17:15,89,47,42,0,0,0
2022-06-02 17:30,87,52,35,0,0,0
2022-06-02 17:45,98,65,33,0,0,0
2022-06-02 18:00,74,51,23,0,0,0
2022-06-02 18:15,82,55,27,0,0,0
2022-06-02 18:30,62,36,26,0,0,0
2022-06-02 18:45,59,36,23,0,0,0
2022-06-02 19:00,62,43,19,0,0,0
2022-06-02 19:15,55,35,20,0,0,0
2022-06-02 19:30,49,27,22,0,0,0
2022-06-02 19:45,59,29,30,0,0,0
2022-06-02 20:00,46,20,26,0,0,0
2022-06-02 20:15,50,26,24,0,0,0
2022-06-02 20:30,33,23,10,0,0,0
2022-06-02 20:45,33,23,10,0,0,0
2022-06-02 21:00,27,11,16,0,0,0
2022-06-02 21:15,40,19,21,0,0,0
2022-06-02 21:30,49,25,24,0,0,0
2022-06-02 21:45,24,7,17,0,0,0
2022-06-02 22:00,21,10,11,0,0,0
2022-06-02 22:15,32,17,15,0,0,0
2022-06-02 22:30,44,25,19,0,0,0
2022-06-02 22:45,23,12,11,0,0,0
2022-06-02 23:00,9,8,1,0,0,0
2022-06-02 23:15,10,4,6,0,0,0
2022-06-02 23:30,12,3,9,0,0,0
2022-06-02 23:45,14,5,9,0,0,0
2022-06-03 00:00,10,5,5,0,0,0
2022-06-03 00:15,8,2,6,0,0,0
2022-06-03 00:30,2,1,1,0,0,0
2022-06-03 00:45,3,0,3,0,0,0
2022-06-03 01:00,1,0,1,0,0,0
2022-06-03 01:15,7,2,5,0,0,0
2022-06-03 01:30,6,3,3,0,0,0
2022-06-03 01:45,1,0,1,0,0,0
2022-06-03 02:00,3,0,3,0,0,0
2022-06-03 02:15,2,1,1,0,0,0
2022-06-03 02:30,2,0,2,0,0,0
2022-06-03 02:45,3,2,1,0,0,0
2022-06-03 03:00,3,0,3,0,0,0
2022-06-03 03:15,3,0,3,0,0,0
2022-06-03 03:30,0,0,0,0,0,0
2022-06-03 03:45,3,0,3,0,0,0
2022-06-03 04:00,0,0,0,0,0,0
2022-06-03 04:15,2,2,0,0,0,0
2022-06-03 04:30,2,2,0,0,0,0
2022-06-03 04:45,6,4,2,0,0,0
2022-06-03 05:00,6,5,1,0,0,0
2022-06-03 05:15,6,1,5,0,0,0
2022-06-03 05:30,10,5,5,0,0,0
2022-06-03 05:45,9,6,3,0,0,0
2022-06-03 06:00,11,8,3,0,0,0
2022-06-03 06:15,17,13,4,0,0,0
2022-06-03 06:30,24,11,13,0,0,0
2022-06-03 06:45,37,17,20,0,0,0
2022-06-03 07:00,46,25,21,0,0,0
2022-06-03 07:15,57,40,17,0,0,0
2022-06-03 07:30,109,80,29,0,0,0
2022-06-03 07:45,110,66,44,0,0,0
2022-06-03 08:00,69,37,32,0,0,0
2022-06-03 08:15,51,27,24,0,0,0
2022-06-03 08:30,57,33,24,0,0,0
2022-06-03 08:45,58,37,21,0,0,0
2022-06-03 09:00,48,31,17,0,0,0
2022-06-03 09:15,41,28,13,0,0,0
2022-06-03 09:30,58,51,7,0,0,0
2022-06-03 09:45,60,48,12,0,0,0
2022-06-03 10:00,55,38,17,0,0,0
2022-06-03 10:15,42,33,9,0,0,0
2022-06-03 10:30,30,21,9,0,0,0
2022-06-03 10:45,31,26,5,0,0,0
2022-06-03 11:00,56,35,21,0,0,0
2022-06-03 11:15,43,34,9,0,0,0
2022-06-03 11:30,37,20,17,0,0,0
2022-06-03 11:45,54,35,19,0,0,0
2022-06-03 12:00,62,39,23,0,0,0
2022-06-03 12:15,55,27,28,0,0,0
2022-06-03 12:30,51,25,26,0,0,0
2022-06-03 12:45,56,37,19,0,0,0
2022-06-03 13:00,80,44,36,0,0,0
2022-06-03 13:15,61,37,24,0,0,0
2022-06-03 13:30,56,33,23,0,0,0
2022-06-03 13:45,80,53,27,0,0,0
2022-06-03 14:00,68,36,32,0,0,0
2022-06-03 14:15,63,29,34,0,0,0
2022-06-03 14:30,63,39,24,0,0,0
2022-06-03 14:45,72,44,28,0,0,0
2022-06-03 15:00,63,38,25,0,0,0
2022-06-03 15:15,73,50,23,0,0,0
2022-06-03 15:30,55,39,16,0,0,0
2022-06-03 15:45,75,50,25,0,0,0
2022-06-03 16:00,70,37,33,0,0,0
2022-06-03 16:15,63,38,25,0,0,0
2022-06-03 16:30,74,47,27,0,0,0
2022-06-03 16:45,55,39,16,0,0,0
2022-06-03 17:00,59,41,18,0,0,0
2022-06-03 17:15,53,35,18,0,0,0
2022-06-03 17:30,71,35,36,0,0,0
2022-06-03 17:45,67,46,21,0,0,0
2022-06-03 18:00,80,58,22,0,0,0
2022-06-03 18:15,71,43,28,0,0,0
2022-06-03 18:30,49,35,14,0,0,0
2022-06-03 18:45,68,47,21,0,0,0
2022-06-03 19:00,53,33,20,0,0,0
2022-06-03 19:15,58,37,21,0,0,0
2022-06-03 19:30,51,38,13,0,0,0
2022-06-03 19:45,40,25,15,0,0,0
2022-06-03 20:00,43,25,18,0,0,0
2022-06-03 20:15,38,19,19,0,0,0
2022-06-03 20:30,20,9,11,0,0,0
2022-06-03 20:45,29,17,12,0,0,0
2022-06-03 21:00,21,15,6,0,0,0
2022-06-03 21:15,36,21,15,0,0,0
2022-06-03 21:30,29,14,15,0,0,0
2022-06-03 21:45,38,14,24,0,0,0
2022-06-03 22:00,24,12,12,0,0,0
2022-06-03 22:15,23,8,15,0,0,0
2022-06-03 22:30,26,12,14,0,0,0
2022-06-03 22:45,18,7,11,0,0,0
2022-06-03 23:00,24,6,18,0,0,0
2022-06-03 23:15,16,6,10,0,0,0
2022-06-03 23:30,32,17,15,0,0,0
2022-06-03 23:45,22,9,13,0,0,0
2022-06-04 00:00,19,14,5,0,0,0
2022-06-04 00:15,13,4,9,0,0,0
2022-06-04 00:30,9,4,5,0,0,0
2022-06-04 00:45,13,5,8,0,0,0
2022-06-04 01:00,17,12,5,0,0,0
2022-06-04 01:15,15,1,14,0,0,0
2022-06-04 01:30,12,3,9,0,0,0
2022-06-04 01:45,8,4,4,0,0,0
2022-06-04 02:00,6,2,4,0,0,0
2022-06-04 02:15,6,2,4,0,0,0
2022-06-04 02:30,4,1,3,0,0,0
2022-06-04 02:45,4,1,3,0,0,0
2022-06-04 03:00,10,4,6,0,0,0
2022-06-04 03:15,3,0,3,0,0,0
2022-06-04 03:30,4,1,3,0,0,0
2022-06-04 03:45,1,0,1,0,0,0
2022-06-04 04:00,2,0,2,0,0,0
2022-06-04 04:15,4,3,1,0,0,0
2022-06-04 04:30,2,0,2,0,0,0
2022-06-04 04:45,5,3,2,0,0,0
2022-06-04 05:00,1,1,0,0,0,0
2022-06-04 05:15,3,1,2,0,0,0
2022-06-04 05:30,4,4,0,0,0,0
2022-06-04 05:45,6,2,4,0,0,0
2022-06-04 06:00,4,1,3,0,0,0
2022-06-04 06:15,1,1,0,0,0,0
2022-06-04 06:30,6,5,1,0,0,0
2022-06-04 06:45,3,2,1,0,0,0
2022-06-04 07:00,4,3,1,0,0,0
2022-06-04 07:15,5,2,3,0,0,0
2022-06-04 07:30,9,6,3,0,0,0
2022-06-04 07:45,18,10,8,0,0,0
2022-06-04 08:00,13,12,1,0,0,0
2022-06-04 08:15,23,14,9,0,0,0
2022-06-04 08:30,16,10,6,0,0,0
2022-06-04 08:45,15,9,6,0,0,0
2022-06-04 09:00,14,9,5,0,0,0
2022-06-04 09:15,29,14,15,0,0,0
2022-06-04 09:30,39,23,16,0,0,0
2022-06-04 09:45,49,43,6,0,0,0
2022-06-04 10:00,25,14,11,0,0,0
2022-06-04 10:15,36,26,10,0,0,0
2022-06-04 10:30,48,42,6,0,0,0
2022-06-04 10:45,45,34,11,0,0,0
2022-06-04 11:00,35,28,7,0,0,0
2022-06-04 11:15,46,42,4,0,0,0
2022-06-04 11:30,35,29,6,0,0,0
2022-06-04 11:45,45,35,10,0,0,0
2022-06-04 12:00,28,20,8,0,0,0
2022-06-04 12:15,48,39,9,0,0,0
2022-06-04 12:30,38,23,15,0,0,0
2022-06-04 12:45,57,41,16,0,0,0
2022-06-04 13:00,45,34,11,0,0,0
2022-06-04 13:15,39,21,18,0,0,0
2022-06-04 13:30,44,31,13,0,0,0
2022-06-04 13:45,47,27,20,0,0,0
2022-06-04 14:00,29,14,15,0,0,0
2022-06-04 14:15,48,28,20,0,0,0
2022-06-04 14:30,44,23,21,0,0,0
2022-06-04 14:45,55,29,26,0,0,0
2022-06-04 15:00,48,26,22,0,0,0
2022-06-04 15:15,36,22,14,0,0,0
2022-06-04 15:30,46,33,13,0,0,0
2022-06-04 15:45,35,16,19,0,0,0
2022-06-04 16:00,52,34,18,0,0,0
2022-06-04 16:15,47,28,19,0,0,0
2022-06-04 16:30,42,30,12,0,0,0
2022-06-04 16:45,60,51,9,0,0,0
2022-06-04 17:00,39,22,17,0,0,0
2022-06-04 17:15,48,25,23,0,0,0
2022-06-04 17:30,27,21,6,0,0,0
2022-06-04 17:45,41,23,18,0,0,0
2022-06-04 18:00,42,21,21,0,0,0
2022-06-04 18:15,40,25,15,0,0,0
2022-06-04 18:30,35,25,10,0,0,0
2022-06-04 18:45,46,27,19,0,0,0
2022-06-04 19:00,35,20,15,0,0,0
2022-06-04 19:15,37,20,17,0,0,0
2022-06-04 19:30,44,23,21,0,0,0
2022-06-04 19:45,34,25,9,0,0,0
2022-06-04 20:00,35,18,17,0,0,0
2022-06-04 20:15,45,28,17,0,0,0
2022-06-04 20:30,26,11,15,0,0,0
2022-06-04 20:45,23,15,8,0,0,0
2022-06-04 21:00,19,13,6,0,0,0
2022-06-04 21:15,24,12,12,0,0,0
2022-06-04 21:30,14,7,7,0,0,0
2022-06-04 21:45,20,11,9,0,0,0
2022-06-04 22:00,10,6,4,0,0,0
2022-06-04 22:15,16,9,7,0,0,0
2022-06-04 22:30,16,4,12,0,0,0
2022-06-04 22:45,15,2,13,0,0,0
2022-06-04 23:00,24,9,15,0,0,0
2022-06-04 23:15,18,1,17,0,0,0
2022-06-04 23:30,18,7,11,0,0,0
2022-06-04 23:45,20,9,11,0,0,0
2022-06-05 00:00,7,5,2,0,0,0
2022-06-05 00:15,14,6,8,0,0,0
2022-06-05 00:30,7,3,4,0,0,0
2022-06-05 00:45,10,6,4,0,0,0
2022-06-05 01:00,16,9,7,0,0,0
2022-06-05 01:15,8,2,6,0,0,0
2022-06-05 01:30,10,3,7,0,0,0
2022-06-05 01:45,9,5,4,0,0,0
2022-06-05 02:00,4,3,1,0,0,0
2022-06-05 02:15,7,1,6,0,0,0
2022-06-05 02:30,3,1,2,0,0,0
2022-06-05 02:45,6,0,6,0,0,0
2022-06-05 03:00,4,1,3,0,0,0
2022-06-05 03:15,8,1,7,0,0,0
2022-06-05 03:30,8,0,8,0,0,0
2022-06-05 03:45,1,0,1,0,0,0
2022-06-05 04:00,5,2,3,0,0,0
2022-06-05 04:15,7,4,3,0,0,0
2022-06-05 04:30,2,2,0,0,0,0
2022-06-05 04:45,1,1,0,0,0,0
2022-06-05 05:00,0,0,0,0,0,0
2022-06-05 05:15,3,2,1,0,0,0
2022-06-05 05:30,2,2,0,0,0,0
2022-06-05 05:45,2,0,2,0,0,0
2022-06-05 06:00,1,1,0,0,0,0
2022-06-05 06:15,0,0,0,0,0,0
2022-06-05 06:30,5,3,2,0,0,0
2022-06-05 06:45,2,2,0,0,0,0
2022-06-05 07:00,1,0,1,0,0,0
2022-06-05 07:15,3,2,1,0,0,0
2022-06-05 07:30,4,4,0,0,0,0
2022-06-05 07:45,10,5,5,0,0,0
2022-06-05 08:00,3,1,2,0,0,0
2022-06-05 08:15,4,2,2,0,0,0
2022-06-05 08:30,6,4,2,0,0,0
2022-06-05 08:45,9,4,5,0,0,0
2022-06-05 09:00,10,8,2,0,0,0
2022-06-05 09:15,12,8,4,0,0,0
2022-06-05 09:30,11,8,3,0,0,0
2022-06-05 09:45,25,17,8,0,0,0
2022-06-05 10:00,15,13,2,0,0,0
2022-06-05 10:15,25,18,7,0,0,0
2022-06-05 10:30,21,17,4,0,0,0
2022-06-05 10:45,14,9,5,0,0,0
2022-06-05 11:00,12,7,5,0,0,0
2022-06-05 11:15,33,17,16,0,0,0
2022-06-05 11:30,14,9,5,0,0,0
2022-06-05 11:45,25,13,12,0,0,0
2022-06-05 12:00,25,16,9,0,0,0
2022-06-05 12:15,9,5,4,0,0,0
2022-06-05 12:30,15,12,3,0,0,0
2022-06-05 12:45,22,14,8,0,0,0
2022-06-05 13:00,32,15,17,0,0,0
2022-06-05 13:15,28,19,9,0,0,0
2022-06-05 13:30,29,18,11,0,0,0
2022-06-05 13:45,28,18,10,0,0,0
2022-06-05 14:00,17,13,4,0,0,0
2022-06-05 14:15,31,24,7,0,0,0
2022-06-05 14:30,17,8,9,0,0,0
2022-06-05 14:45,22,22,0,0,0,0
2022-06-05 15:00,16,9,7,0,0,0
2022-06-05 15:15,20,10,10,0,0,0
2022-06-05 15:30,8,4,4,0,0,0
2022-06-05 15:45,18,12,6,0,0,0
2022-06-05 16:00,13,6,7,0,0,0
2022-06-05 16:15,17,11,6,0,0,0
2022-06-05 16:30,13,9,4,0,0,0
2022-06-05 16:45,20,12,8,0,0,0
2022-06-05 17:00,17,10,7,0,0,0
2022-06-05 17:15,21,10,11,0,0,0
2022-06-05 17:30,23,15,8,0,0,0
2022-06-05 17:45,10,8,2,0,0,0
2022-06-05 18:00,26,19,7,0,0,0
2022-06-05 18:15,23,19,4,0,0,0
2022-06-05 18:30,16,8,8,0,0,0
2022-06-05 18:45,18,13,5,0,0,0
2022-06-05 19:00,27,17,10,0,0,0
2022-06-05 19:15,13,5,8,0,0,0
2022-06-05 19:30,15,10,5,0,0,0
2022-06-05 19:45,13,5,8,0,0,0
2022-06-05 20:00,17,12,5,0,0,0
2022-06-05 20:15,9,8,1,0,0,0
2022-06-05 20:30,15,11,4,0,0,0
2022-06-05 20:45,5,3,2,0,0,0
2022-06-05 21:00,17,4,13,0,0,0
2022-06-05 21:15,10,8,2,0,0,0
2022-06-05 21:30,12,8,4,0,0,0
2022-06-05 21:45,5,2,3,0,0,0
2022-06-05 22:00,12,6,6,0,0,0
2022-06-05 22:15,8,3,5,0,0,0
2022-06-05 22:30,9,6,3,0,0,0
2022-06-05 22:45,9,3,6,0,0,0
2022-06-05 23:00,8,0,8,0,0,0
2022-06-05 23:15,4,0,4,0,0,0
2022-06-05 23:30,8,3,5,0,0,0
2022-06-05 23:45,10,6,4,0,0,0
2022-06-06 00:00,0,0,0,0,0,0
2022-06-06 00:15,4,0,4,0,0,0
2022-06-06 00:30,3,2,1,0,0,0
2022-06-06 00:45,6,4,2,0,0,0
2022-06-06 01:00,0,0,0,0,0,0
2022-06-06 01:15,5,4,1,0,0,0
2022-06-06 01:30,5,0,5,0,0,0
2022-06-06 01:45,5,3,2,0,0,0
2022-06-06 02:00,0,0,0,0,0,0
2022-06-06 02:15,1,1,0,0,0,0
2022-06-06 02:30,4,0,4,0,0,0
2022-06-06 02:45,4,1,3,0,0,0
2022-06-06 03:00,2,1,1,0,0,0
2022-06-06 03:15,3,1,2,0,0,0
2022-06-06 03:30,0,0,0,0,0,0
2022-06-06 03:45,1,0,1,0,0,0
2022-06-06 04:00,0,0,0,0,0,0
2022-06-06 04:15,1,0,1,0,0,0
2022-06-06 04:30,1,1,0,0,0,0
2022-06-06 04:45,0,0,0,0,0,0
2022-06-06 05:00,1,0,1,0,0,0
2022-06-06 05:15,3,1,2,0,0,0
2022-06-06 05:30,2,2,0,0,0,0
2022-06-06 05:45,3,2,1,0,0,0
2022-06-06 06:00,4,3,1,0,0,0
2022-06-06 06:15,3,3,0,0,0,0
2022-06-06 06:30,3,3,0,0,0,0
2022-06-06 06:45,6,3,3,0,0,0
2022-06-06 07:00,0,0,0,0,0,0
2022-06-06 07:15,4,4,0,0,0,0
2022-06-06 07:30,4,2,2,0,0,0
2022-06-06 07:45,5,4,1,0,0,0
2022-06-06 08:00,4,4,0,0,0,0
2022-06-06 08:15,8,6,2,0,0,0
2022-06-06 08:30,0,0,0,0,0,0
2022-06-06 08:45,7,3,4,0,0,0
2022-06-06 09:00,10,7,3,0,0,0
2022-06-06 09:15,9,7,2,0,0,0
2022-06-06 09:30,12,5,7,0,0,0
2022-06-06 09:45,28,20,8,0,0,0
2022-06-06 10:00,14,10,4,0,0,0
2022-06-06 10:15,19,17,2,0,0,0
2022-06-06 10:30,31,23,8,0,0,0
2022-06-06 10:45,31,27,4,0,0,0
2022-06-06 11:00,21,15,6,0,0,0
2022-06-06 11:15,28,20,8,0,0,0
2022-06-06 11:30,20,13,7,0,0,0
2022-06-06 11:45,18,12,6,0,0,0
2022-06-06 12:00,32,23,9,0,0,0
2022-06-06 12:15,26,14,12,0,0,0
2022-06-06 12:30,21,16,5,0,0,0
2022-06-06 12:45,41,24,17,0,0,0
2022-06-06 13:00,28,15,13,0,0,0
2022-06-06 13:15,40,21,19,0,0,0
2022-06-06 13:30,24,16,8,0,0,0
2022-06-06 13:45,39,25,14,0,0,0
2022-06-06 14:00,20,11,9,0,0,0
2022-06-06 14:15,18,10,8,0,0,0
2022-06-06 14:30,23,18,5,0,0,0
2022-06-06 14:45,34,21,13,0,0,0
2022-06-06 15:00,25,13,12,0,0,0
2022-06-06 15:15,31,21,10,0,0,0
2022-06-06 15:30,42,35,7,0,0,0
2022-06-06 15:45,49,34,15,0,0,0
2022-06-06 16:00,27,14,13,0,0,0
2022-06-06 16:15,26,12,14,0,0,0
2022-06-06 16:30,30,20,10,0,0,0
2022-06-06 16:45,23,17,6,0,0,0
2022-06-06 17:00,30,19,11,0,0,0
2022-06-06 17:15,24,15,9,0,0,0
2022-06-06 17:30,40,25,15,0,0,0
2022-06-06 17:45,24,16,8,0,0,0
2022-06-06 18:00,20,10,10,0,0,0
2022-06-06 18:15,37,25,12,0,0,0
2022-06-06 18:30,26,9,17,0,0,0
2022-06-06 18:45,32,17,15,0,0,0
2022-06-06 19:00,23,9,14,0,0,0
2022-06-06 19:15,26,14,12,0,0,0
2022-06-06 19:30,17,12,5,0,0,0
2022-06-06 19:45,27,14,13,0,0,0
2022-06-06 20:00,22,11,11,0,0,0
2022-06-06 20:15,30,18,12,0,0,0
2022-06-06 20:30,17,8,9,0,0,0
2022-06-06 20:45,14,9,5,0,0,0
2022-06-06 21:00,14,4,10,0,0,0
2022-06-06 21:15,16,7,9,0,0,0
2022-06-06 21:30,9,7,2,0,0,0
2022-06-06 21:45,10,4,6,0,0,0
2022-06-06 22:00,8,5,3,0,0,0
2022-06-06 22:15,7,4,3,0,0,0
2022-06-06 22:30,10,6,4,0,0,0
2022-06-06 22:45,11,4,7,0,0,0
2022-06-06 23:00,4,1,3,0,0,0
2022-06-06 23:15,4,4,0,0,0,0
2022-06-06 23:30,4,2,2,0,0,0
2022-06-06 23:45,7,7,0,0,0,0
