Datetime,100034980 (Hammer Straße),101034980 (Hammer Straße stadteinwärts),102034980 (Hammer Straße stadtauswärts),100034980-status,101034980-status,102034980-status
2022-06-01 00:00,6,2,4,0,0,0
2022-06-01 00:15,7,2,5,0,0,0
2022-06-01 00:30,12,1,11,0,0,0
2022-06-01 00:45,6,1,5,0,0,0
2022-06-01 01:00,1,1,0,0,0,0
2022-06-01 01:15,2,0,2,0,0,0
2022-06-01 01:30,6,1,5,0,0,0
2022-06-01 01:45,1,0,1,0,0,0
2022-06-01 02:00,3,0,3,0,0,0
2022-06-01 02:15,3,2,1,0,0,0
2022-06-01 02:30,2,0,2,0,0,0
2022-06-01 02:45,2,1,1,0,0,0
2022-06-01 03:00,0,0,0,0,0,0
2022-06-01 03:15,0,0,0,0,0,0
2022-06-01 03:30,0,0,0,0,0,0
2022-06-01 03:45,4,3,1,0,0,0
2022-06-01 04:00,3,2,1,0,0,0
2022-06-01 04:15,3,3,0,0,0,0
2022-06-01 04:30,2,1,1,0,0,0
2022-06-01 04:45,3,3,0,0,0,0
2022-06-01 05:00,7,5,2,0,0,0
2022-06-01 05:15,11,10,1,0,0,0
2022-06-01 05:30,20,10,10,0,0,0
2022-06-01 05:45,17,13,4,0,0,0
2022-06-01 06:00,34,28,6,0,0,0
2022-06-01 06:15,41,30,11,0,0,0
2022-06-01 06:30,71,43,28,0,0,0
2022-06-01 06:45,71,40,31,0,0,0
2022-06-01 07:00,90,63,27,0,0,0
2022-06-01 07:15,132,73,59,0,0,0
2022-06-01 07:30,199,121,78,0,0,0
2022-06-01 07:45,215,137,78,0,0,0
2022-06-01 08:00,153,104,49,0,0,0
2022-06-01 08:15,171,116,55,0,0,0
2022-06-01 08:30,138,93,45,0,0,0
2022-06-01 08:45,182,126,56,0,0,0
2022-06-01 09:00,121,75,46,0,0,0
2022-06-01 09:15,127,84,43,0,0,0
2022-06-01 09:30,107,64,43,0,0,0
2022-06-01 09:45,169,109,60,0,0,0
2022-06-01 10:00,140,82,58,0,0,0
2022-06-01 10:15,110,55,55,0,0,0
2022-06-01 10:30,117,74,43,0,0,0
2022-06-01 10:45,129,67,62,0,0,0
2022-06-01 11:00,122,57,65,0,0,0
2022-06-01 11:15,154,68,86,0,0,0
2022-06-01 11:30,148,74,74,0,0,0
2022-06-01 11:45,169,85,84,0,0,0
2022-06-01 12:00,154,63,91,0,0,0
2022-06-01 12:15,154,62,92,0,0,0
2022-06-01 12:30,185,83,102,0,0,0
2022-06-01 12:45,140,72,68,0,0,0
2022-06-01 13:00,172,70,102,0,0,0
2022-06-01 13:15,158,65,93,0,0,0
2022-06-01 13:30,147,59,88,0,0,0
2022-06-01 13:45,178,78,100,0,0,0
2022-06-01 14:00,159,57,102,0,0,0
2022-06-01 14:15,157,67,90,0,0,0
2022-06-01 14:30,161,61,100,0,0,0
2022-06-01 14:45,201,67,134,0,0,0
2022-06-01 15:00,130,45,85,0,0,0
2022-06-01 15:15,80,25,55,0,0,0
2022-06-01 15:30,126,42,84,0,0,0
2022-06-01 15:45,184,79,105,0,0,0
2022-06-01 16:00,192,92,100,0,0,0
2022-06-01 16:15,187,77,110,0,0,0
2022-06-01 16:30,170,71,99,0,0,0
2022-06-01 16:45,204,71,133,0,0,0
2022-06-01 17:00,213,79,134,0,0,0
2022-06-01 17:15,189,77,112,0,0,0
2022-06-01 17:30,173,68,105,0,0,0
2022-06-01 17:45,206,85,121,0,0,0
2022-06-01 18:00,174,61,113,0,0,0
2022-06-01 18:15,159,62,97,0,0,0
2022-06-01 18:30,104,38,66,0,0,0
2022-06-01 18:45,128,60,68,0,0,0
2022-06-01 19:00,122,51,71,0,0,0
2022-06-01 19:15,116,47,69,0,0,0
2022-06-01 19:30,83,31,52,0,0,0
2022-06-01 19:45,106,38,68,0,0,0
2022-06-01 20:00,103,37,66,0,0,0
2022-06-01 20:15,92,32,60,0,0,0
2022-06-01 20:30,75,39,36,0,0,0
2022-06-01 20:45,52,21,31,0,0,0
2022-06-01 21:00,62,20,42,0,0,0
2022-06-01 21:15,58,16,42,0,0,0
2022-06-01 21:30,73,24,49,0,0,0
2022-06-01 21:45,66,24,42,0,0,0
2022-06-01 22:00,44,13,31,0,0,0
2022-06-01 22:15,40,15,25,0,0,0
2022-06-01 22:30,39,16,23,0,0,0
2022-06-01 22:45,41,12,29,0,0,0
2022-06-01 23:00,38,9,29,0,0,0
2022-06-01 23:15,37,10,27,0,0,0
2022-06-01 23:30,35,17,18,0,0,0
2022-06-01 23:45,27,13,14,0,0,0
2022-06-02 00:00,23,16,7,0,0,0
2022-06-02 00:15,16,5,11,0,0,0
2022-06-02 00:30,16,11,5,0,0,0
2022-06-02 00:45,18,5,13,0,0,0
2022-06-02 01:00,5,2,3,0,0,0
2022-06-02 01:15,15,2,13,0,0,0
2022-06-02 01:30,5,0,5,0,0,0
2022-06-02 01:45,9,3,6,0,0,0
2022-06-02 02:00,2,0,2,0,0,0
2022-06-02 02:15,5,0,5,0,0,0
2022-06-02 02:30,0,0,0,0,0,0
2022-06-02 02:45,8,0,8,0,0,0
2022-06-02 03:00,6,0,6,0,0,0
2022-06-02 03:15,7,1,6,0,0,0
2022-06-02 03:30,8,2,6,0,0,0
2022-06-02 03:45,11,3,8,0,0,0
2022-06-02 04:00,2,2,0,0,0,0
2022-06-02 04:15,9,3,6,0,0,0
2022-06-02 04:30,4,2,2,0,0,0
2022-06-02 04:45,4,3,1,0,0,0
2022-06-02 05:00,2,1,1,0,0,0
2022-06-02 05:15,9,4,5,0,0,0
2022-06-02 05:30,24,19,5,0,0,0
2022-06-02 05:45,16,12,4,0,0,0
2022-06-02 06:00,38,28,10,0,0,0
2022-06-02 06:15,34,23,11,0,0,0
2022-06-02 06:30,43,27,16,0,0,0
2022-06-02 06:45,66,40,26,0,0,0
2022-06-02 07:00,78,48,30,0,0,0
2022-06-02 07:15,117,60,57,0,0,0
2022-06-02 07:30,167,108,59,0,0,0
2022-06-02 07:45,171,122,49,0,0,0
2022-06-02 08:00,146,88,58,0,0,0
2022-06-02 08:15,159,98,61,0,0,0
2022-06-02 08:30,133,78,55,0,0,0
2022-06-02 08:45,158,100,58,0,0,0
2022-06-02 09:00,112,81,31,0,0,0
2022-06-02 09:15,128,96,32,0,0,0
2022-06-02 09:30,108,70,38,0,0,0
2022-06-02 09:45,122,77,45,0,0,0
2022-06-02 10:00,133,83,50,0,0,0
2022-06-02 10:15,97,56,41,0,0,0
2022-06-02 10:30,99,60,39,0,0,0
2022-06-02 10:45,128,72,56,0,0,0
2022-06-02 11:00,121,68,53,0,0,0
2022-06-02 11:15,116,56,60,0,0,0
2022-06-02 11:30,121,54,67,0,0,0
2022-06-02 11:45,164,87,77,0,0,0
2022-06-02 12:00,151,68,83,0,0,0
2022-06-02 12:15,133,48,85,0,0,0
2022-06-02 12:30,155,63,92,0,0,0
2022-06-02 12:45,155,60,95,0,0,0
2022-06-02 13:00,172,60,112,0,0,0
2022-06-02 13:15,160,73,87,0,0,0
2022-06-02 13:30,133,54,79,0,0,0
2022-06-02 13:45,174,90,84,0,0,0
2022-06-02 14:00,169,83,86,0,0,0
2022-06-02 14:15,141,61,80,0,0,0
2022-06-02 14:30,145,67,78,0,0,0
2022-06-02 14:45,173,82,91,0,0,0
2022-06-02 15:00,175,74,101,0,0,0
2022-06-02 15:15,209,90,119,0,0,0
2022-06-02 15:30,204,106,98,0,0,0
2022-06-02 15:45,233,96,137,0,0,0
2022-06-02 16:00,209,95,114,0,0,0
2022-06-02 16:15,201,71,130,0,0,0
2022-06-02 16:30,234,101,133,0,0,0
2022-06-02 16:45,216,92,124,0,0,0
2022-06-02 17:00,225,99,126,0,0,0
2022-06-02 17:15,206,76,130,0,0,0
2022-06-02 17:30,224,90,134,0,0,0
2022-06-02 17:45,236,113,123,0,0,0
2022-06-02 18:00,216,77,139,0,0,0
2022-06-02 18:15,215,84,131,0,0,0
2022-06-02 18:30,196,73,123,0,0,0
2022-06-02 18:45,189,80,109,0,0,0
2022-06-02 19:00,181,81,100,0,0,0
2022-06-02 19:15,162,73,89,0,0,0
2022-06-02 19:30,138,52,86,0,0,0
2022-06-02 19:45,150,59,91,0,0,0
2022-06-02 20:00,90,29,61,0,0,0
2022-06-02 20:15,84,26,58,0,0,0
2022-06-02 20:30,70,23,47,0,0,0
2022-06-02 20:45,80,20,60,0,0,0
2022-06-02 21:00,62,26,36,0,0,0
2022-06-02 21:15,67,27,40,0,0,0
2022-06-02 21:30,72,20,52,0,0,0
2022-06-02 21:45,61,21,40,0,0,0
2022-06-02 22:00,63,18,45,0,0,0
2022-06-02 22:15,52,14,38,0,0,0
2022-06-02 22:30,63,10,53,0,0,0
2022-06-02 22:45,46,9,37,0,0,0
2022-06-02 23:00,66,41,25,0,0,0
2022-06-02 23:15,49,19,30,0,0,0
2022-06-02 23:30,16,5,11,0,0,0
2022-06-02 23:45,25,13,12,0,0,0
2022-06-03 00:00,20,9,11,0,0,0
2022-06-03 00:15,16,2,14,0,0,0
2022-06-03 00:30,10,3,7,0,0,0
2022-06-03 00:45,11,1,10,0,0,0
2022-06-03 01:00,10,1,9,0,0,0
2022-06-03 01:15,8,3,5,0,0,0
2022-06-03 01:30,3,0,3,0,0,0
2022-06-03 01:45,3,0,3,0,0,0
2022-06-03 02:00,7,0,7,0,0,0
2022-06-03 02:15,1,0,1,0,0,0
2022-06-03 02:30,5,1,4,0,0,0
2022-06-03 02:45,5,0,5,0,0,0
2022-06-03 03:00,4,0,4,0,0,0
2022-06-03 03:15,4,0,4,0,0,0
2022-06-03 03:30,2,0,2,0,0,0
2022-06-03 03:45,3,0,3,0,0,0
2022-06-03 04:00,3,1,2,0,0,0
2022-06-03 04:15,5,4,1,0,0,0
2022-06-03 04:30,2,1,1,0,0,0
2022-06-03 04:45,5,4,1,0,0,0
2022-06-03 05:00,1,1,0,0,0,0
2022-06-03 05:15,10,7,3,0,0,0
2022-06-03 05:30,14,10,4,0,0,0
2022-06-03 05:45,20,17,3,0,0,0
2022-06-03 06:00,29,28,1,0,0,0
2022-06-03 06:15,26,17,9,0,0,0
2022-06-03 06:30,40,21,19,0,0,0
2022-06-03 06:45,56,33,23,0,0,0
2022-06-03 07:00,88,40,48,0,0,0
2022-06-03 07:15,103,62,41,0,0,0
2022-06-03 07:30,183,113,70,0,0,0
2022-06-03 07:45,144,97,47,0,0,0
2022-06-03 08:00,114,75,39,0,0,0
2022-06-03 08:15,128,78,50,0,0,0
2022-06-03 08:30,125,82,43,0,0,0
2022-06-03 08:45,151,116,35,0,0,0
2022-06-03 09:00,95,71,24,0,0,0
2022-06-03 09:15,92,68,24,0,0,0
2022-06-03 09:30,97,63,34,0,0,0
2022-06-03 09:45,158,100,58,0,0,0
2022-06-03 10:00,125,79,46,0,0,0
2022-06-03 10:15,108,63,45,0,0,0
2022-06-03 10:30,115,63,52,0,0,0
2022-06-03 10:45,138,76,62,0,0,0
2022-06-03 11:00,128,56,72,0,0,0
2022-06-03 11:15,135,73,62,0,0,0
2022-06-03 11:30,133,66,67,0,0,0
2022-06-03 11:45,159,79,80,0,0,0
2022-06-03 12:00,168,75,93,0,0,0
2022-06-03 12:15,159,75,84,0,0,0
2022-06-03 12:30,160,88,72,0,0,0
2022-06-03 12:45,164,83,81,0,0,0
2022-06-03 13:00,198,82,116,0,0,0
2022-06-03 13:15,149,54,95,0,0,0
2022-06-03 13:30,162,56,106,0,0,0
2022-06-03 13:45,200,87,113,0,0,0
2022-06-03 14:00,174,72,102,0,0,0
2022-06-03 14:15,212,91,121,0,0,0
2022-06-03 14:30,191,76,115,0,0,0
2022-06-03 14:45,175,83,92,0,0,0
2022-06-03 15:00,198,87,111,0,0,0
2022-06-03 15:15,180,95,85,0,0,0
2022-06-03 15:30,183,96,87,0,0,0
2022-06-03 15:45,184,73,111,0,0,0
2022-06-03 16:00,154,64,90,0,0,0
2022-06-03 16:15,173,66,107,0,0,0
2022-06-03 16:30,171,78,93,0,0,0
2022-06-03 16:45,225,102,123,0,0,0
2022-06-03 17:00,144,51,93,0,0,0
2022-06-03 17:15,137,50,87,0,0,0
2022-06-03 17:30,191,83,108,0,0,0
2022-06-03 17:45,155,61,94,0,0,0
2022-06-03 18:00,156,48,108,0,0,0
2022-06-03 18:15,158,68,90,0,0,0
2022-06-03 18:30,163,62,101,0,0,0
2022-06-03 18:45,159,75,84,0,0,0
2022-06-03 19:00,137,54,83,0,0,0
2022-06-03 19:15,131,57,74,0,0,0
2022-06-03 19:30,114,53,61,0,0,0
2022-06-03 19:45,108,49,59,0,0,0
2022-06-03 20:00,111,41,70,0,0,0
2022-06-03 20:15,75,36,39,0,0,0
2022-06-03 20:30,87,33,54,0,0,0
2022-06-03 20:45,74,28,46,0,0,0
2022-06-03 21:00,56,21,35,0,0,0
2022-06-03 21:15,55,16,39,0,0,0
2022-06-03 21:30,62,17,45,0,0,0
2022-06-03 21:45,63,29,34,0,0,0
2022-06-03 22:00,43,18,25,0,0,0
2022-06-03 22:15,50,17,33,0,0,0
2022-06-03 22:30,72,29,43,0,0,0
2022-06-03 22:45,49,17,32,0,0,0
2022-06-03 23:00,51,19,32,0,0,0
2022-06-03 23:15,32,13,19,0,0,0
2022-06-03 23:30,57,25,32,0,0,0
2022-06-03 23:45,48,14,34,0,0,0
2022-06-04 00:00,36,17,19,0,0,0
2022-06-04 00:15,34,12,22,0,0,0
2022-06-04 00:30,16,5,11,0,0,0
2022-06-04 00:45,28,16,12,0,0,0
2022-06-04 01:00,29,9,20,0,0,0
2022-06-04 01:15,12,6,6,0,0,0
2022-06-04 01:30,11,4,7,0,0,0
2022-06-04 01:45,14,5,9,0,0,0
2022-06-04 02:00,19,2,17,0,0,0
2022-06-04 02:15,9,5,4,0,0,0
2022-06-04 02:30,8,0,8,0,0,0
2022-06-04 02:45,8,3,5,0,0,0
2022-06-04 03:00,6,1,5,0,0,0
2022-06-04 03:15,15,5,10,0,0,0
2022-06-04 03:30,11,0,11,0,0,0
2022-06-04 03:45,9,3,6,0,0,0
2022-06-04 04:00,8,5,3,0,0,0
2022-06-04 04:15,6,4,2,0,0,0
2022-06-04 04:30,3,1,2,0,0,0
2022-06-04 04:45,5,2,3,0,0,0
2022-06-04 05:00,4,1,3,0,0,0
2022-06-04 05:15,3,3,0,0,0,0
2022-06-04 05:30,12,7,5,0,0,0
2022-06-04 05:45,6,4,2,0,0,0
2022-06-04 06:00,15,13,2,0,0,0
2022-06-04 06:15,4,2,2,0,0,0
2022-06-04 06:30,7,5,2,0,0,0
2022-06-04 06:45,7,4,3,0,0,0
2022-06-04 07:00,12,7,5,0,0,0
2022-06-04 07:15,19,14,5,0,0,0
2022-06-04 07:30,23,17,6,0,0,0
2022-06-04 07:45,37,23,14,0,0,0
2022-06-04 08:00,25,14,11,0,0,0
2022-06-04 08:15,29,15,14,0,0,0
2022-06-04 08:30,47,27,20,0,0,0
2022-06-04 08:45,62,40,22,0,0,0
2022-06-04 09:00,66,41,25,0,0,0
2022-06-04 09:15,70,56,14,0,0,0
2022-06-04 09:30,85,55,30,0,0,0
2022-06-04 09:45,120,93,27,0,0,0
2022-06-04 10:00,93,69,24,0,0,0
2022-06-04 10:15,122,79,43,0,0,0
2022-06-04 10:30,113,78,35,0,0,0
2022-06-04 10:45,147,93,54,0,0,0
2022-06-04 11:00,129,82,47,0,0,0
2022-06-04 11:15,114,78,36,0,0,0
2022-06-04 11:30,151,98,53,0,0,0
2022-06-04 11:45,164,99,65,0,0,0
2022-06-04 12:00,156,87,69,0,0,0
2022-06-04 12:15,140,79,61,0,0,0
2022-06-04 12:30,141,78,63,0,0,0
2022-06-04 12:45,171,90,81,0,0,0
2022-06-04 13:00,166,78,88,0,0,0
2022-06-04 13:15,201,98,103,0,0,0
2022-06-04 13:30,204,97,107,0,0,0
2022-06-04 13:45,172,77,95,0,0,0
2022-06-04 14:00,159,75,84,0,0,0
2022-06-04 14:15,171,91,80,0,0,0
2022-06-04 14:30,147,57,90,0,0,0
2022-06-04 14:45,148,66,82,0,0,0
2022-06-04 15:00,136,61,75,0,0,0
2022-06-04 15:15,153,68,85,0,0,0
2022-06-04 15:30,156,72,84,0,0,0
2022-06-04 15:45,133,54,79,0,0,0
2022-06-04 16:00,144,52,92,0,0,0
2022-06-04 16:15,153,62,91,0,0,0
2022-06-04 16:30,105,46,59,0,0,0
2022-06-04 16:45,146,47,99,0,0,0
2022-06-04 17:00,132,65,67,0,0,0
2022-06-04 17:15,126,60,66,0,0,0
2022-06-04 17:30,182,56,126,0,0,0
2022-06-04 17:45,156,73,83,0,0,0
2022-06-04 18:00,125,51,74,0,0,0
2022-06-04 18:15,123,51,72,0,0,0
2022-06-04 18:30,110,48,62,0,0,0
2022-06-04 18:45,109,51,58,0,0,0
2022-06-04 19:00,105,45,60,0,0,0
2022-06-04 19:15,101,37,64,0,0,0
2022-06-04 19:30,107,43,64,0,0,0
2022-06-04 19:45,84,26,58,0,0,0
2022-06-04 20:00,85,22,63,0,0,0
2022-06-04 20:15,67,29,38,0,0,0
2022-06-04 20:30,58,20,38,0,0,0
2022-06-04 20:45,46,21,25,0,0,0
2022-06-04 21:00,52,23,29,0,0,0
2022-06-04 21:15,41,17,24,0,0,0
2022-06-04 21:30,42,11,31,0,0,0
2022-06-04 21:45,47,17,30,0,0,0
2022-06-04 22:00,37,13,24,0,0,0
2022-06-04 22:15,42,15,27,0,0,0
2022-06-04 22:30,52,21,31,0,0,0
2022-06-04 22:45,30,3,27,0,0,0
2022-06-04 23:00,51,17,34,0,0,0
2022-06-04 23:15,38,13,25,0,0,0
2022-06-04 23:30,31,14,17,0,0,0
2022-06-04 23:45,44,20,24,0,0,0
2022-06-05 00:00,37,17,20,0,0,0
2022-06-05 00:15,28,5,23,0,0,0
2022-06-05 00:30,20,2,18,0,0,0
2022-06-05 00:45,30,20,10,0,0,0
2022-06-05 01:00,34,18,16,0,0,0
2022-06-05 01:15,19,6,13,0,0,0
2022-06-05 01:30,21,6,15,0,0,0
2022-06-05 01:45,18,5,13,0,0,0
2022-06-05 02:00,23,3,20,0,0,0
2022-06-05 02:15,12,4,8,0,0,0
2022-06-05 02:30,18,6,12,0,0,0
2022-06-05 02:45,12,4,8,0,0,0
2022-06-05 03:00,4,1,3,0,0,0
2022-06-05 03:15,7,0,7,0,0,0
2022-06-05 03:30,7,1,6,0,0,0
2022-06-05 03:45,7,0,7,0,0,0
2022-06-05 04:00,4,3,1,0,0,0
2022-06-05 04:15,3,2,1,0,0,0
2022-06-05 04:30,6,3,3,0,0,0
2022-06-05 04:45,4,1,3,0,0,0
2022-06-05 05:00,4,2,2,0,0,0
2022-06-05 05:15,7,1,6,0,0,0
2022-06-05 05:30,4,3,1,0,0,0
2022-06-05 05:45,1,0,1,0,0,0
2022-06-05 06:00,4,2,2,0,0,0
2022-06-05 06:15,5,3,2,0,0,0
2022-06-05 06:30,7,5,2,0,0,0
2022-06-05 06:45,6,0,6,0,0,0
2022-06-05 07:00,5,3,2,0,0,0
2022-06-05 07:15,5,3,2,0,0,0
2022-06-05 07:30,5,4,1,0,0,0
2022-06-05 07:45,8,5,3,0,0,0
2022-06-05 08:00,13,7,6,0,0,0
2022-06-05 08:15,15,8,7,0,0,0
2022-06-05 08:30,29,13,16,0,0,0
2022-06-05 08:45,17,14,3,0,0,0
2022-06-05 09:00,17,7,10,0,0,0
2022-06-05 09:15,19,15,4,0,0,0
2022-06-05 09:30,29,13,16,0,0,0
2022-06-05 09:45,38,24,14,0,0,0
2022-06-05 10:00,36,22,14,0,0,0
2022-06-05 10:15,35,22,13,0,0,0
2022-06-05 10:30,38,19,19,0,0,0
2022-06-05 10:45,49,31,18,0,0,0
2022-06-05 11:00,53,41,12,0,0,0
2022-06-05 11:15,33,15,18,0,0,0
2022-06-05 11:30,43,20,23,0,0,0
2022-06-05 11:45,61,34,27,0,0,0
2022-06-05 12:00,41,16,25,0,0,0
2022-06-05 12:15,53,33,20,0,0,0
2022-06-05 12:30,58,21,37,0,0,0
2022-06-05 12:45,64,21,43,0,0,0
2022-06-05 13:00,46,20,26,0,0,0
2022-06-05 13:15,53,26,27,0,0,0
2022-06-05 13:30,53,13,40,0,0,0
2022-06-05 13:45,57,16,41,0,0,0
2022-06-05 14:00,28,13,15,0,0,0
2022-06-05 14:15,25,13,12,0,0,0
2022-06-05 14:30,21,9,12,0,0,0
2022-06-05 14:45,42,13,29,0,0,0
2022-06-05 15:00,40,13,27,0,0,0
2022-06-05 15:15,32,15,17,0,0,0
2022-06-05 15:30,30,16,14,0,0,0
2022-06-05 15:45,45,22,23,0,0,0
2022-06-05 16:00,20,10,10,0,0,0
2022-06-05 16:15,37,15,22,0,0,0
2022-06-05 16:30,52,27,25,0,0,0
2022-06-05 16:45,55,25,30,0,0,0
2022-06-05 17:00,41,23,18,0,0,0
2022-06-05 17:15,28,13,15,0,0,0
2022-06-05 17:30,33,14,19,0,0,0
2022-06-05 17:45,27,14,13,0,0,0
2022-06-05 18:00,39,11,28,0,0,0
2022-06-05 18:15,28,11,17,0,0,0
2022-06-05 18:30,34,16,18,0,0,0
2022-06-05 18:45,35,19,16,0,0,0
2022-06-05 19:00,36,19,17,0,0,0
2022-06-05 19:15,37,21,16,0,0,0
2022-06-05 19:30,29,14,15,0,0,0
2022-06-05 19:45,39,21,18,0,0,0
2022-06-05 20:00,30,13,17,0,0,0
2022-06-05 20:15,28,10,18,0,0,0
2022-06-05 20:30,19,5,14,0,0,0
2022-06-05 20:45,24,7,17,0,0,0
2022-06-05 21:00,22,8,14,0,0,0
2022-06-05 21:15,20,13,7,0,0,0
2022-06-05 21:30,23,11,12,0,0,0
2022-06-05 21:45,22,9,13,0,0,0
2022-06-05 22:00,22,7,15,0,0,0
2022-06-05 22:15,14,6,8,0,0,0
2022-06-05 22:30,19,9,10,0,0,0
2022-06-05 22:45,20,5,15,0,0,0
2022-06-05 23:00,16,4,12,0,0,0
2022-06-05 23:15,14,6,8,0,0,0
2022-06-05 23:30,5,1,4,0,0,0
2022-06-05 23:45,8,4,4,0,0,0
2022-06-06 00:00,6,4,2,0,0,0
2022-06-06 00:15,4,1,3,0,0,0
2022-06-06 00:30,9,2,7,0,0,0
2022-06-06 00:45,8,3,5,0,0,0
2022-06-06 01:00,4,0,4,0,0,0
2022-06-06 01:15,7,1,6,0,0,0
2022-06-06 01:30,9,5,4,0,0,0
2022-06-06 01:45,7,5,2,0,0,0
2022-06-06 02:00,5,4,1,0,0,0
2022-06-06 02:15,7,2,5,0,0,0
2022-06-06 02:30,4,3,1,0,0,0
2022-06-06 02:45,3,1,2,0,0,0
2022-06-06 03:00,6,0,6,0,0,0
2022-06-06 03:15,1,0,1,0,0,0
2022-06-06 03:30,0,0,0,0,0,0
2022-06-06 03:45,5,1,4,0,0,0
2022-06-06 04:00,2,1,1,0,0,0
2022-06-06 04:15,0,0,0,0,0,0
2022-06-06 04:30,1,0,1,0,0,0
2022-06-06 04:45,1,1,0,0,0,0
2022-06-06 05:00,1,0,1,0,0,0
2022-06-06 05:15,2,1,1,0,0,0
2022-06-06 05:30,3,2,1,0,0,0
2022-06-06 05:45,3,1,2,0,0,0
2022-06-06 06:00,3,2,1,0,0,0
2022-06-06 06:15,4,2,2,0,0,0
2022-06-06 06:30,5,4,1,0,0,0
2022-06-06 06:45,3,2,1,0,0,0
2022-06-06 07:00,10,4,6,0,0,0
2022-06-06 07:15,8,6,2,0,0,0
2022-06-06 07:30,9,6,3,0,0,0
2022-06-06 07:45,8,3,5,0,0,0
2022-06-06 08:00,8,6,2,0,0,0
2022-06-06 08:15,13,6,7,0,0,0
2022-06-06 08:30,19,9,10,0,0,0
2022-06-06 08:45,15,10,5,0,0,0
2022-06-06 09:00,14,6,8,0,0,0
2022-06-06 09:15,39,27,12,0,0,0
2022-06-06 09:30,22,12,10,0,0,0
2022-06-06 09:45,37,22,15,0,0,0
2022-06-06 10:00,39,24,15,0,0,0
2022-06-06 10:15,37,27,10,0,0,0
2022-06-06 10:30,49,30,19,0,0,0
2022-06-06 10:45,57,40,17,0,0,0
2022-06-06 11:00,67,40,27,0,0,0
2022-06-06 11:15,43,20,23,0,0,0
2022-06-06 11:30,61,37,24,0,0,0
2022-06-06 11:45,63,36,27,0,0,0
2022-06-06 12:00,58,27,31,0,0,0
2022-06-06 12:15,60,22,38,0,0,0
2022-06-06 12:30,66,34,32,0,0,0
2022-06-06 12:45,64,29,35,0,0,0
2022-06-06 13:00,73,35,38,0,0,0
2022-06-06 13:15,73,31,42,0,0,0
2022-06-06 13:30,67,26,41,0,0,0
2022-06-06 13:45,79,42,37,0,0,0
2022-06-06 14:00,72,28,44,0,0,0
2022-06-06 14:15,47,17,30,0,0,0
2022-06-06 14:30,49,28,21,0,0,0
2022-06-06 14:45,97,47,50,0,0,0
2022-06-06 15:00,66,25,41,0,0,0
2022-06-06 15:15,73,29,44,0,0,0
2022-06-06 15:30,80,42,38,0,0,0
2022-06-06 15:45,73,30,43,0,0,0
2022-06-06 16:00,74,35,39,0,0,0
2022-06-06 16:15,44,14,30,0,0,0
2022-06-06 16:30,84,34,50,0,0,0
2022-06-06 16:45,80,34,46,0,0,0
2022-06-06 17:00,77,26,51,0,0,0
2022-06-06 17:15,85,34,51,0,0,0
2022-06-06 17:30,72,31,41,0,0,0
2022-06-06 17:45,74,30,44,0,0,0
2022-06-06 18:00,77,33,44,0,0,0
2022-06-06 18:15,72,30,42,0,0,0
2022-06-06 18:30,65,25,40,0,0,0
2022-06-06 18:45,78,37,41,0,0,0
2022-06-06 19:00,53,19,34,0,0,0
2022-06-06 19:15,61,29,32,0,0,0
2022-06-06 19:30,39,13,26,0,0,0
2022-06-06 19:45,72,25,47,0,0,0
2022-06-06 20:00,51,22,29,0,0,0
2022-06-06 20:15,35,18,17,0,0,0
2022-06-06 20:30,37,15,22,0,0,0
2022-06-06 20:45,41,16,25,0,0,0
2022-06-06 21:00,33,9,24,0,0,0
2022-06-06 21:15,26,10,16,0,0,0
2022-06-06 21:30,29,9,20,0,0,0
2022-06-06 21:45,20,4,16,0,0,0
2022-06-06 22:00,24,6,18,0,0,0
2022-06-06 22:15,19,5,14,0,0,0
2022-06-06 22:30,18,5,13,0,0,0
2022-06-06 22:45,10,4,6,0,0,0
2022-06-06 23:00,22,8,14,0,0,0
2022-06-06 23:15,5,1,4,0,0,0
2022-06-06 23:30,11,5,6,0,0,0
2022-06-06 23:45,6,2,4,0,0,0
2022-06-07 00:00,6,0,6,0,0,0
2022-06-07 00:15,5,1,4,0,0,0
2022-06-07 00:30,3,0,3,0,0,0
2022-06-07 00:45,0,0,0,0,0,0
2022-06-07 01:00,3,1,2,0,0,0
2022-06-07 01:15,3,1,2,0,0,0
2022-06-07 01:30,2,0,2,0,0,0
2022-06-07 01:45,1,0,1,0,0,0
2022-06-07 02:00,2,0,2,0,0,0
2022-06-07 02:15,1,0,1,0,0,0
2022-06-07 02:30,0,0,0,0,0,0
2022-06-07 02:45,1,1,0,0,0,0
2022-06-07 03:00,1,1,0,0,0,0
2022-06-07 03:15,0,0,0,0,0,0
2022-06-07 03:30,0,0,0,0,0,0
2022-06-07 03:45,1,1,0,0,0,0
2022-06-07 04:00,1,1,0,0,0,0
2022-06-07 04:15,3,3,0,0,0,0
2022-06-07 04:30,0,0,0,0,0,0
2022-06-07 04:45,6,5,1,0,0,0
2022-06-07 05:00,3,2,1,0,0,0
2022-06-07 05:15,7,6,1,0,0,0
2022-06-07 05:30,19,13,6,0,0,0
2022-06-07 05:45,25,24,1,0,0,0
2022-06-07 06:00,41,36,5,0,0,0
2022-06-07 06:15,44,27,17,0,0,0
2022-06-07 06:30,53,36,17,0,0,0
2022-06-07 06:45,69,43,26,0,0,0
2022-06-07 07:00,81,48,33,0,0,0
2022-06-07 07:15,116,78,38,0,0,0
2022-06-07 07:30,175,100,75,0,0,0
2022-06-07 07:45,171,117,54,0,0,0
2022-06-07 08:00,133,90,43,0,0,0
2022-06-07 08:15,158,105,53,0,0,0
2022-06-07 08:30,141,100,41,0,0,0
2022-06-07 08:45,167,112,55,0,0,0
2022-06-07 09:00,103,65,38,0,0,0
2022-06-07 09:15,101,67,34,0,0,0
2022-06-07 09:30,97,63,34,0,0,0
2022-06-07 09:45,95,68,27,0,0,0
2022-06-07 10:00,86,51,35,0,0,0
2022-06-07 10:15,96,63,33,0,0,0
2022-06-07 10:30,90,47,43,0,0,0
2022-06-07 10:45,101,58,43,0,0,0
2022-06-07 11:00,91,49,42,0,0,0
2022-06-07 11:15,110,56,54,0,0,0
2022-06-07 11:30,101,54,47,0,0,0
2022-06-07 11:45,120,63,57,0,0,0
2022-06-07 12:00,137,60,77,0,0,0
2022-06-07 12:15,143,55,88,0,0,0
2022-06-07 12:30,133,62,71,0,0,0
2022-06-07 12:45,157,72,85,0,0,0
2022-06-07 13:00,156,62,94,0,0,0
2022-06-07 13:15,138,69,69,0,0,0
2022-06-07 13:30,134,56,78,0,0,0
2022-06-07 13:45,136,66,70,0,0,0
2022-06-07 14:00,177,82,95,0,0,0
2022-06-07 14:15,131,61,70,0,0,0
2022-06-07 14:30,146,68,78,0,0,0
2022-06-07 14:45,170,80,90,0,0,0
2022-06-07 15:00,164,74,90,0,0,0
2022-06-07 15:15,153,59,94,0,0,0
2022-06-07 15:30,167,65,102,0,0,0
2022-06-07 15:45,179,88,91,0,0,0
2022-06-07 16:00,179,72,107,0,0,0
2022-06-07 16:15,197,81,116,0,0,0
2022-06-07 16:30,186,72,114,0,0,0
2022-06-07 16:45,204,77,127,0,0,0
2022-06-07 17:00,206,94,112,0,0,0
2022-06-07 17:15,201,75,126,0,0,0
2022-06-07 17:30,189,82,107,0,0,0
2022-06-07 17:45,216,88,128,0,0,0
2022-06-07 18:00,177,75,102,0,0,0
2022-06-07 18:15,153,63,90,0,0,0
2022-06-07 18:30,160,65,95,0,0,0
2022-06-07 18:45,145,58,87,0,0,0
2022-06-07 19:00,123,42,81,0,0,0
2022-06-07 19:15,123,47,76,0,0,0
2022-06-07 19:30,102,35,67,0,0,0
2022-06-07 19:45,131,47,84,0,0,0
2022-06-07 20:00,82,27,55,0,0,0
2022-06-07 20:15,72,30,42,0,0,0
2022-06-07 20:30,56,20,36,0,0,0
2022-06-07 20:45,77,44,33,0,0,0
2022-06-07 21:00,59,19,40,0,0,0
2022-06-07 21:15,56,15,41,0,0,0
2022-06-07 21:30,46,16,30,0,0,0
2022-06-07 21:45,45,13,32,0,0,0
2022-06-07 22:00,54,13,41,0,0,0
2022-06-07 22:15,41,13,28,0,0,0
2022-06-07 22:30,49,9,40,0,0,0
2022-06-07 22:45,28,9,19,0,0,0
2022-06-07 23:00,29,8,21,0,0,0
2022-06-07 23:15,23,12,11,0,0,0
2022-06-07 23:30,21,7,14,0,0,0
2022-06-07 23:45,5,2,3,0,0,0
2022-06-08 00:00,19,1,18,0,0,0
2022-06-08 00:15,6,3,3,0,0,0
2022-06-08 00:30,8,2,6,0,0,0
2022-06-08 00:45,4,2,2,0,0,0
2022-06-08 01:00,7,0,7,0,0,0
2022-06-08 01:15,6,1,5,0,0,0
2022-06-08 01:30,1,0,1,0,0,0
2022-06-08 01:45,3,1,2,0,0,0
2022-06-08 02:00,0,0,0,0,0,0
2022-06-08 02:15,1,0,1,0,0,0
2022-06-08 02:30,0,0,0,0,0,0
2022-06-08 02:45,2,1,1,0,0,0
2022-06-08 03:00,0,0,0,0,0,0
2022-06-08 03:15,2,2,0,0,0,0
2022-06-08 03:30,1,0,1,0,0,0
2022-06-08 03:45,3,3,0,0,0,0
2022-06-08 04:00,3,0,3,0,0,0
2022-06-08 04:15,1,1,0,0,0,0
2022-06-08 04:30,1,1,0,0,0,0
2022-06-08 04:45,5,4,1,0,0,0
2022-06-08 05:00,6,4,2,0,0,0
2022-06-08 05:15,6,5,1,0,0,0
2022-06-08 05:30,18,12,6,0,0,0
2022-06-08 05:45,22,19,3,0,0,0
2022-06-08 06:00,35,28,7,0,0,0
2022-06-08 06:15,32,23,9,0,0,0
2022-06-08 06:30,42,24,18,0,0,0
2022-06-08 06:45,65,40,25,0,0,0
2022-06-08 07:00,85,46,39,0,0,0
2022-06-08 07:15,121,73,48,0,0,0
2022-06-08 07:30,183,107,76,0,0,0
2022-06-08 07:45,164,107,57,0,0,0
2022-06-08 08:00,122,75,47,0,0,0
2022-06-08 08:15,176,109,67,0,0,0
2022-06-08 08:30,149,106,43,0,0,0
2022-06-08 08:45,159,110,49,0,0,0
2022-06-08 09:00,115,75,40,0,0,0
2022-06-08 09:15,109,75,34,0,0,0
2022-06-08 09:30,120,79,41,0,0,0
2022-06-08 09:45,155,108,47,0,0,0
2022-06-08 10:00,101,55,46,0,0,0
2022-06-08 10:15,118,61,57,0,0,0
2022-06-08 10:30,95,60,35,0,0,0
2022-06-08 10:45,132,73,59,0,0,0
2022-06-08 11:00,140,60,80,0,0,0
2022-06-08 11:15,114,48,66,0,0,0
2022-06-08 11:30,144,64,80,0,0,0
2022-06-08 11:45,133,69,64,0,0,0
2022-06-08 12:00,145,68,77,0,0,0
2022-06-08 12:15,122,56,66,0,0,0
2022-06-08 12:30,158,65,93,0,0,0
2022-06-08 12:45,187,87,100,0,0,0
2022-06-08 13:00,141,57,84,0,0,0
2022-06-08 13:15,132,53,79,0,0,0
2022-06-08 13:30,147,60,87,0,0,0
2022-06-08 13:45,160,50,110,0,0,0
2022-06-08 14:00,143,60,83,0,0,0
2022-06-08 14:15,142,61,81,0,0,0
2022-06-08 14:30,142,48,94,0,0,0
2022-06-08 14:45,172,67,105,0,0,0
2022-06-08 15:00,114,34,80,0,0,0
2022-06-08 15:15,85,26,59,0,0,0
2022-06-08 15:30,88,30,58,0,0,0
2022-06-08 15:45,147,57,90,0,0,0
2022-06-08 16:00,160,67,93,0,0,0
2022-06-08 16:15,133,50,83,0,0,0
2022-06-08 16:30,145,67,78,0,0,0
2022-06-08 16:45,136,60,76,0,0,0
2022-06-08 17:00,126,45,81,0,0,0
2022-06-08 17:15,110,37,73,0,0,0
2022-06-08 17:30,128,47,81,0,0,0
2022-06-08 17:45,149,54,95,0,0,0
2022-06-08 18:00,135,38,97,0,0,0
2022-06-08 18:15,158,59,99,0,0,0
2022-06-08 18:30,79,23,56,0,0,0
2022-06-08 18:45,81,30,51,0,0,0
2022-06-08 19:00,74,20,54,0,0,0
2022-06-08 19:15,104,37,67,0,0,0
2022-06-08 19:30,78,31,47,0,0,0
2022-06-08 19:45,69,28,41,0,0,0
2022-06-08 20:00,51,22,29,0,0,0
2022-06-08 20:15,53,24,29,0,0,0
2022-06-08 20:30,38,23,15,0,0,0
2022-06-08 20:45,52,21,31,0,0,0
2022-06-08 21:00,39,19,20,0,0,0
2022-06-08 21:15,52,15,37,0,0,0
2022-06-08 21:30,38,10,28,0,0,0
2022-06-08 21:45,40,12,28,0,0,0
2022-06-08 22:00,43,15,28,0,0,0
2022-06-08 22:15,46,11,35,0,0,0
2022-06-08 22:30,25,8,17,0,0,0
2022-06-08 22:45,33,11,22,0,0,0
2022-06-08 23:00,22,3,19,0,0,0
2022-06-08 23:15,21,6,15,0,0,0
2022-06-08 23:30,9,1,8,0,0,0
2022-06-08 23:45,22,6,16,0,0,0
2022-06-09 00:00,12,3,9,0,0,0
2022-06-09 00:15,4,0,4,0,0,0
2022-06-09 00:30,12,2,10,0,0,0
2022-06-09 00:45,8,2,6,0,0,0
2022-06-09 01:00,1,0,1,0,0,0
2022-06-09 01:15,6,3,3,0,0,0
2022-06-09 01:30,3,2,1,0,0,0
2022-06-09 01:45,3,2,1,0,0,0
2022-06-09 02:00,2,0,2,0,0,0
2022-06-09 02:15,5,0,5,0,0,0
2022-06-09 02:30,3,0,3,0,0,0
2022-06-09 02:45,1,0,1,0,0,0
2022-06-09 03:00,1,0,1,0,0,0
2022-06-09 03:15,6,1,5,0,0,0
2022-06-09 03:30,2,1,1,0,0,0
2022-06-09 03:45,2,1,1,0,0,0
2022-06-09 04:00,3,2,1,0,0,0
2022-06-09 04:15,3,0,3,0,0,0
2022-06-09 04:30,2,1,1,0,0,0
2022-06-09 04:45,6,6,0,0,0,0
2022-06-09 05:00,3,3,0,0,0,0
2022-06-09 05:15,8,6,2,0,0,0
2022-06-09 05:30,13,11,2,0,0,0
2022-06-09 05:45,22,18,4,0,0,0
2022-06-09 06:00,25,22,3,0,0,0
2022-06-09 06:15,40,29,11,0,0,0
2022-06-09 06:30,38,23,15,0,0,0
2022-06-09 06:45,68,38,30,0,0,0
2022-06-09 07:00,81,46,35,0,0,0
2022-06-09 07:15,104,60,44,0,0,0
2022-06-09 07:30,168,114,54,0,0,0
2022-06-09 07:45,165,112,53,0,0,0
2022-06-09 08:00,155,102,53,0,0,0
2022-06-09 08:15,133,81,52,0,0,0
2022-06-09 08:30,128,89,39,0,0,0
2022-06-09 08:45,150,104,46,0,0,0
2022-06-09 09:00,106,68,38,0,0,0
2022-06-09 09:15,111,80,31,0,0,0
2022-06-09 09:30,101,65,36,0,0,0
2022-06-09 09:45,137,92,45,0,0,0
2022-06-09 10:00,124,72,52,0,0,0
2022-06-09 10:15,92,52,40,0,0,0
2022-06-09 10:30,108,53,55,0,0,0
2022-06-09 10:45,112,64,48,0,0,0
2022-06-09 11:00,92,42,50,0,0,0
2022-06-09 11:15,100,50,50,0,0,0
2022-06-09 11:30,111,64,47,0,0,0
2022-06-09 11:45,146,79,67,0,0,0
2022-06-09 12:00,126,60,66,0,0,0
2022-06-09 12:15,146,59,87,0,0,0
2022-06-09 12:30,143,64,79,0,0,0
2022-06-09 12:45,123,49,74,0,0,0
2022-06-09 13:00,148,60,88,0,0,0
2022-06-09 13:15,132,48,84,0,0,0
2022-06-09 13:30,112,55,57,0,0,0
2022-06-09 13:45,151,84,67,0,0,0
2022-06-09 14:00,146,59,87,0,0,0
2022-06-09 14:15,133,53,80,0,0,0
2022-06-09 14:30,117,47,70,0,0,0
2022-06-09 14:45,158,78,80,0,0,0
2022-06-09 15:00,120,42,78,0,0,0
2022-06-09 15:15,147,67,80,0,0,0
2022-06-09 15:30,159,74,85,0,0,0
2022-06-09 15:45,182,74,108,0,0,0
2022-06-09 16:00,186,83,103,0,0,0
2022-06-09 16:15,178,73,105,0,0,0
2022-06-09 16:30,191,75,116,0,0,0
2022-06-09 16:45,194,86,108,0,0,0
2022-06-09 17:00,169,68,101,0,0,0
2022-06-09 17:15,197,84,113,0,0,0
2022-06-09 17:30,213,73,140,0,0,0
2022-06-09 17:45,209,98,111,0,0,0
2022-06-09 18:00,173,74,99,0,0,0
2022-06-09 18:15,191,70,121,0,0,0
2022-06-09 18:30,168,63,105,0,0,0
2022-06-09 18:45,156,63,93,0,0,0
2022-06-09 19:00,116,43,73,0,0,0
2022-06-09 19:15,135,47,88,0,0,0
2022-06-09 19:30,110,33,77,0,0,0
2022-06-09 19:45,91,24,67,0,0,0
2022-06-09 20:00,98,36,62,0,0,0
2022-06-09 20:15,62,17,45,0,0,0
2022-06-09 20:30,54,18,36,0,0,0
2022-06-09 20:45,66,16,50,0,0,0
2022-06-09 21:00,71,33,38,0,0,0
2022-06-09 21:15,66,25,41,0,0,0
2022-06-09 21:30,48,16,32,0,0,0
2022-06-09 21:45,60,26,34,0,0,0
2022-06-09 22:00,63,17,46,0,0,0
2022-06-09 22:15,61,23,38,0,0,0
2022-06-09 22:30,40,9,31,0,0,0
2022-06-09 22:45,34,7,27,0,0,0
2022-06-09 23:00,41,14,27,0,0,0
2022-06-09 23:15,34,9,25,0,0,0
2022-06-09 23:30,21,10,11,0,0,0
2022-06-09 23:45,23,7,16,0,0,0
2022-06-10 00:00,15,4,11,0,0,0
2022-06-10 00:15,13,7,6,0,0,0
2022-06-10 00:30,9,1,8,0,0,0
2022-06-10 00:45,9,2,7,0,0,0
2022-06-10 01:00,5,1,4,0,0,0
2022-06-10 01:15,5,2,3,0,0,0
2022-06-10 01:30,6,1,5,0,0,0
2022-06-10 01:45,5,1,4,0,0,0
2022-06-10 02:00,3,2,1,0,0,0
2022-06-10 02:15,4,0,4,0,0,0
2022-06-10 02:30,3,1,2,0,0,0
2022-06-10 02:45,1,0,1,0,0,0
2022-06-10 03:00,4,4,0,0,0,0
2022-06-10 03:15,2,0,2,0,0,0
2022-06-10 03:30,1,0,1,0,0,0
2022-06-10 03:45,1,1,0,0,0,0
2022-06-10 04:00,1,1,0,0,0,0
2022-06-10 04:15,3,2,1,0,0,0
2022-06-10 04:30,3,2,1,0,0,0
2022-06-10 04:45,6,6,0,0,0,0
2022-06-10 05:00,5,1,4,0,0,0
2022-06-10 05:15,12,10,2,0,0,0
2022-06-10 05:30,18,13,5,0,0,0
2022-06-10 05:45,18,16,2,0,0,0
2022-06-10 06:00,30,25,5,0,0,0
2022-06-10 06:15,33,24,9,0,0,0
2022-06-10 06:30,45,29,16,0,0,0
2022-06-10 06:45,56,29,27,0,0,0
2022-06-10 07:00,76,44,32,0,0,0
2022-06-10 07:15,127,78,49,0,0,0
2022-06-10 07:30,156,98,58,0,0,0
2022-06-10 07:45,148,105,43,0,0,0
2022-06-10 08:00,127,93,34,0,0,0
2022-06-10 08:15,129,81,48,0,0,0
2022-06-10 08:30,117,75,42,0,0,0
2022-06-10 08:45,148,98,50,0,0,0
2022-06-10 09:00,109,68,41,0,0,0
2022-06-10 09:15,118,78,40,0,0,0
2022-06-10 09:30,100,63,37,0,0,0
2022-06-10 09:45,106,69,37,0,0,0
2022-06-10 10:00,105,61,44,0,0,0
2022-06-10 10:15,126,76,50,0,0,0
2022-06-10 10:30,113,71,42,0,0,0
2022-06-10 10:45,122,67,55,0,0,0
2022-06-10 11:00,127,68,59,0,0,0
2022-06-10 11:15,144,75,69,0,0,0
2022-06-10 11:30,148,71,77,0,0,0
2022-06-10 11:45,149,72,77,0,0,0
2022-06-10 12:00,136,80,56,0,0,0
2022-06-10 12:15,157,82,75,0,0,0
2022-06-10 12:30,119,57,62,0,0,0
2022-06-10 12:45,170,74,96,0,0,0
2022-06-10 13:00,171,76,95,0,0,0
2022-06-10 13:15,200,89,111,0,0,0
2022-06-10 13:30,175,70,105,0,0,0
2022-06-10 13:45,155,78,77,0,0,0
2022-06-10 14:00,203,81,122,0,0,0
2022-06-10 14:15,181,78,103,0,0,0
2022-06-10 14:30,198,79,119,0,0,0
2022-06-10 14:45,182,75,107,0,0,0
2022-06-10 15:00,173,74,99,0,0,0
2022-06-10 15:15,174,86,88,0,0,0
2022-06-10 15:30,196,78,118,0,0,0
2022-06-10 15:45,192,93,99,0,0,0
2022-06-10 16:00,175,68,107,0,0,0
2022-06-10 16:15,139,56,83,0,0,0
2022-06-10 16:30,189,66,123,0,0,0
2022-06-10 16:45,168,86,82,0,0,0
2022-06-10 17:00,170,71,99,0,0,0
2022-06-10 17:15,165,63,102,0,0,0
2022-06-10 17:30,183,73,110,0,0,0
2022-06-10 17:45,206,81,125,0,0,0
2022-06-10 18:00,168,60,108,0,0,0
2022-06-10 18:15,166,72,94,0,0,0
2022-06-10 18:30,156,70,86,0,0,0
2022-06-10 18:45,159,79,80,0,0,0
2022-06-10 19:00,113,43,70,0,0,0
2022-06-10 19:15,125,39,86,0,0,0
2022-06-10 19:30,112,52,60,0,0,0
2022-06-10 19:45,109,51,58,0,0,0
2022-06-10 20:00,88,42,46,0,0,0
2022-06-10 20:15,66,28,38,0,0,0
2022-06-10 20:30,71,21,50,0,0,0
2022-06-10 20:45,57,27,30,0,0,0
2022-06-10 21:00,70,36,34,0,0,0
2022-06-10 21:15,56,20,36,0,0,0
2022-06-10 21:30,59,19,40,0,0,0
2022-06-10 21:45,53,22,31,0,0,0
2022-06-10 22:00,57,12,45,0,0,0
2022-06-10 22:15,54,21,33,0,0,0
2022-06-10 22:30,43,13,30,0,0,0
2022-06-10 22:45,46,20,26,0,0,0
2022-06-10 23:00,63,23,40,0,0,0
2022-06-10 23:15,52,24,28,0,0,0
2022-06-10 23:30,46,21,25,0,0,0
2022-06-10 23:45,38,16,22,0,0,0
